NM_MUNICIPIO;NR_ZONA;NR_SECAO;NR_LOCAL_VOTACAO;QT_APTOS;QT_COMPARECIMENTO;QT_ABSTENCOES
CUIABÁ;1;147;1015;153;132;21
CUIABÁ;1;149;1015;152;134;18
CUIABÁ;1;150;1015;156;134;22
CUIABÁ;1;154;1260;324;273;51
CUIABÁ;1;156;1015;159;130;29
CUIABÁ;1;157;1015;154;129;25
CUIABÁ;1;158;1015;153;130;23
CUIABÁ;1;159;1015;154;128;26
CUIABÁ;1;160;1015;152;132;20
CUIABÁ;1;161;1015;157;141;16
CUIABÁ;1;166;1104;391;335;56
CUIABÁ;1;169;1015;150;131;19
CUIABÁ;1;170;1015;155;135;20
CUIABÁ;1;172;1015;155;133;22
CUIABÁ;1;174;1260;217;184;33
CUIABÁ;1;176;1015;149;128;21
CUIABÁ;1;178;1015;153;128;25
CUIABÁ;1;179;1015;147;136;11
CUIABÁ;1;180;1015;154;135;19
CUIABÁ;1;181;1015;153;123;30
CUIABÁ;1;181;1015;151;121;30
CUIABÁ;1;183;1260;220;195;25
CUIABÁ;1;186;1260;216;188;28
CUIABÁ;1;187;1015;154;128;26
CUIABÁ;1;189;1015;151;126;25
CUIABÁ;1;190;2933;185;162;23
CUIABÁ;1;190;2933;174;151;23
CUIABÁ;1;191;1015;154;138;16
CUIABÁ;1;192;1015;152;136;16
CUIABÁ;1;202;1104;386;316;70
CUIABÁ;1;203;1104;390;327;63
CUIABÁ;1;447;1945;373;314;59
CUIABÁ;1;448;1945;378;323;55
CUIABÁ;1;449;1945;372;327;45
CUIABÁ;1;501;2593;388;322;66
CUIABÁ;1;502;2593;384;335;49
CUIABÁ;1;503;2593;383;323;60
CUIABÁ;1;504;2593;388;320;68
CUIABÁ;1;505;2593;389;323;66
CUIABÁ;1;506;2593;382;317;65
CUIABÁ;1;507;2593;385;317;68
CUIABÁ;1;508;2593;384;313;71
CUIABÁ;1;509;2593;389;304;85
CUIABÁ;1;510;2593;387;316;71
CUIABÁ;1;511;1104;390;323;67
CUIABÁ;1;512;1104;389;325;64
CUIABÁ;1;513;1104;390;318;72
CUIABÁ;1;720;1015;154;142;12
CUIABÁ;1;737;1945;380;317;63
CUIABÁ;1;761;2593;387;335;52
CUIABÁ;1;793;2593;388;345;43
CUIABÁ;1;813;1015;154;139;15
CUIABÁ;1;819;1104;389;333;56
CUIABÁ;1;841;1104;386;317;69
CUIABÁ;1;843;1104;388;329;59
CUIABÁ;1;844;1104;383;325;58
CUIABÁ;1;845;1945;371;323;48
CUIABÁ;1;849;1945;373;321;52
CUIABÁ;1;850;2437;395;319;76
CUIABÁ;1;851;2437;390;342;48
CUIABÁ;1;852;2437;386;333;53
CUIABÁ;1;853;2437;398;335;63
CUIABÁ;1;854;2445;344;285;59
CUIABÁ;1;855;2445;344;292;52
CUIABÁ;1;856;2445;345;308;37
CUIABÁ;1;857;2445;347;303;44
CUIABÁ;1;858;2445;340;298;42
CUIABÁ;1;862;2917;311;262;49
CUIABÁ;1;863;2917;297;244;53
CUIABÁ;1;864;2917;294;243;51
CUIABÁ;1;865;2917;297;240;57
CUIABÁ;1;866;2917;312;263;49
CUIABÁ;1;867;2917;319;279;40
CUIABÁ;1;868;2470;288;241;47
CUIABÁ;1;869;2470;286;246;40
CUIABÁ;1;870;2488;367;306;61
CUIABÁ;1;871;2488;372;298;74
CUIABÁ;1;872;2488;372;292;80
CUIABÁ;1;873;2488;372;294;78
CUIABÁ;1;874;2488;373;289;84
CUIABÁ;1;875;2488;368;303;65
CUIABÁ;1;876;2488;372;314;58
CUIABÁ;1;877;2488;369;309;60
CUIABÁ;1;878;2488;368;302;66
CUIABÁ;1;879;2488;375;312;63
CUIABÁ;1;880;2488;369;297;72
CUIABÁ;1;881;2488;373;303;70
CUIABÁ;1;900;2526;278;243;35
CUIABÁ;1;901;2526;276;245;31
CUIABÁ;1;902;2526;278;244;34
CUIABÁ;1;903;2526;287;259;28
CUIABÁ;1;904;2526;286;253;33
CUIABÁ;1;905;2526;284;242;42
CUIABÁ;1;906;2526;279;236;43
CUIABÁ;1;907;2526;276;234;42
CUIABÁ;1;908;2933;186;157;29
CUIABÁ;1;912;2437;391;339;52
CUIABÁ;1;915;2550;379;323;56
CUIABÁ;1;916;2593;383;309;74
CUIABÁ;1;917;1945;374;315;59
CUIABÁ;1;920;2550;383;323;60
CUIABÁ;1;922;2437;389;317;72
CUIABÁ;1;923;2445;343;298;45
CUIABÁ;1;924;1015;155;138;17
CUIABÁ;1;926;2917;317;267;50
CUIABÁ;1;927;2470;283;234;49
CUIABÁ;1;929;2550;377;312;65
CUIABÁ;1;930;2437;387;331;56
CUIABÁ;1;932;2593;386;322;64
CUIABÁ;1;935;2917;361;277;84
CUIABÁ;1;936;2550;375;314;61
ACORIZAL;1;937;1015;179;138;41
ACORIZAL;1;938;1015;179;133;46
ACORIZAL;1;939;1015;179;153;26
ACORIZAL;1;940;1015;176;140;36
ACORIZAL;1;941;1015;179;152;27
ACORIZAL;1;942;1015;181;157;24
ACORIZAL;1;943;1023;382;312;70
ACORIZAL;1;944;1023;377;316;61
ACORIZAL;1;945;1023;375;322;53
ACORIZAL;1;946;1023;372;321;51
ACORIZAL;1;947;1023;382;309;73
ACORIZAL;1;948;1023;374;279;95
ACORIZAL;1;949;1031;330;271;59
ACORIZAL;1;950;1031;328;283;45
ACORIZAL;1;951;1031;329;273;56
ACORIZAL;1;953;1074;163;131;32
ACORIZAL;1;954;1074;158;140;18
ACORIZAL;1;955;1074;160;132;28
ACORIZAL;1;956;1074;157;135;22
ACORIZAL;1;957;1082;222;201;21
ACORIZAL;1;958;1112;331;281;50
ACORIZAL;1;959;1120;197;176;21
ACORIZAL;1;960;1139;209;170;39
ACORIZAL;1;961;1198;121;95;26
ACORIZAL;1;962;1163;92;88;4
ACORIZAL;1;963;1210;78;70;8
ACORIZAL;1;965;1015;180;153;27
CUIABÁ;1;966;2615;210;175;35
CUIABÁ;1;967;2615;208;186;22
CUIABÁ;1;968;2615;211;179;32
CUIABÁ;1;969;2615;210;178;32
CUIABÁ;1;970;2615;211;177;34
CUIABÁ;1;971;2615;209;174;35
CUIABÁ;1;972;2615;210;172;38
CUIABÁ;1;973;2615;210;183;27
CUIABÁ;1;974;2615;212;169;43
CUIABÁ;1;975;2615;212;182;30
CUIABÁ;1;976;2615;208;182;26
CUIABÁ;1;977;2615;211;179;32
CUIABÁ;1;978;2615;212;185;27
CUIABÁ;1;979;2615;211;177;34
CUIABÁ;1;980;2615;206;180;26
CUIABÁ;1;981;2615;212;186;26
CUIABÁ;1;982;2623;324;278;46
CUIABÁ;1;983;2623;328;270;58
CUIABÁ;1;984;2623;325;282;43
CUIABÁ;1;985;2623;322;272;50
CUIABÁ;1;986;2623;320;281;39
CUIABÁ;1;987;2623;325;274;51
CUIABÁ;1;988;2623;326;275;51
CUIABÁ;1;989;2623;320;260;60
CUIABÁ;1;990;2623;320;265;55
CUIABÁ;1;991;2623;324;281;43
CUIABÁ;1;992;2623;325;256;69
CUIABÁ;1;993;2933;449;394;55
CUIABÁ;1;993;2933;206;178;28
CUIABÁ;1;994;2933;447;384;63
CUIABÁ;1;994;2933;203;171;32
CUIABÁ;1;995;2933;448;395;53
CUIABÁ;1;995;2933;200;177;23
CUIABÁ;1;996;2640;289;247;42
CUIABÁ;1;997;2640;280;250;30
CUIABÁ;1;998;2640;288;241;47
CUIABÁ;1;999;2640;291;259;32
CUIABÁ;1;1000;2640;291;256;35
CUIABÁ;1;1001;2640;290;248;42
CUIABÁ;1;1002;2640;287;267;20
CUIABÁ;1;1003;2640;284;255;29
CUIABÁ;1;1004;2640;281;244;37
CUIABÁ;1;1005;2640;282;242;40
CUIABÁ;1;1006;2658;334;288;46
CUIABÁ;1;1007;2658;337;284;53
CUIABÁ;1;1008;2658;333;275;58
CUIABÁ;1;1009;2658;338;291;47
CUIABÁ;1;1010;2658;337;275;62
CUIABÁ;1;1011;2658;334;284;50
CUIABÁ;1;1012;2658;334;287;47
CUIABÁ;1;1013;2658;355;292;63
CUIABÁ;1;1014;2666;380;316;64
CUIABÁ;1;1015;2666;372;312;60
CUIABÁ;1;1016;2666;376;311;65
CUIABÁ;1;1017;2666;377;324;53
CUIABÁ;1;1018;2666;375;323;52
CUIABÁ;1;1019;2666;378;313;65
CUIABÁ;1;1020;2666;375;323;52
CUIABÁ;1;1021;2941;179;141;38
CUIABÁ;1;1022;2941;181;157;24
CUIABÁ;1;1023;2941;177;139;38
CUIABÁ;1;1024;2682;390;333;57
CUIABÁ;1;1025;2682;392;326;66
CUIABÁ;1;1026;2682;388;337;51
CUIABÁ;1;1027;2682;431;366;65
CUIABÁ;1;1028;2690;221;196;25
CUIABÁ;1;1029;2690;226;201;25
CUIABÁ;1;1030;2690;224;200;24
CUIABÁ;1;1031;2690;217;197;20
CUIABÁ;1;1032;2704;285;247;38
CUIABÁ;1;1033;2704;281;242;39
CUIABÁ;1;1034;2704;275;244;31
CUIABÁ;1;1035;2704;276;244;32
CUIABÁ;1;1036;2704;274;241;33
CUIABÁ;1;1037;2712;385;331;54
CUIABÁ;1;1038;2712;387;321;66
CUIABÁ;1;1039;2712;379;315;64
CUIABÁ;1;1040;2712;385;323;62
CUIABÁ;1;1041;2712;390;324;66
CUIABÁ;1;1042;2712;382;326;56
CUIABÁ;1;1043;2712;388;323;65
CUIABÁ;1;1044;2720;343;290;53
CUIABÁ;1;1045;2720;345;288;57
CUIABÁ;1;1046;2720;343;305;38
CUIABÁ;1;1047;2720;341;291;50
CUIABÁ;1;1048;2720;344;304;40
CUIABÁ;1;1049;2720;343;279;64
CUIABÁ;1;1050;2720;341;291;50
CUIABÁ;1;1051;2720;337;286;51
CUIABÁ;1;1052;2720;338;291;47
CUIABÁ;1;1053;2739;322;287;35
CUIABÁ;1;1055;2739;317;271;46
CUIABÁ;1;1056;2739;315;264;51
CUIABÁ;1;1057;2933;188;153;35
CUIABÁ;1;1058;2933;190;147;43
CUIABÁ;1;1059;2933;179;133;46
CUIABÁ;1;1060;2755;278;234;44
CUIABÁ;1;1061;2755;276;241;35
CUIABÁ;1;1062;2755;276;243;33
CUIABÁ;1;1063;2755;273;225;48
CUIABÁ;1;1064;2755;276;230;46
CUIABÁ;1;1065;2755;273;230;43
CUIABÁ;1;1066;2755;280;237;43
CUIABÁ;1;1067;2755;275;239;36
CUIABÁ;1;1068;2755;270;237;33
CUIABÁ;1;1069;2755;270;222;48
CUIABÁ;1;1071;2860;295;261;34
CUIABÁ;1;1073;2860;302;260;42
CUIABÁ;1;1075;2933;198;169;29
CUIABÁ;1;1077;2933;193;164;29
CUIABÁ;1;1078;2780;294;247;47
CUIABÁ;1;1079;2780;293;255;38
CUIABÁ;1;1080;2780;292;252;40
CUIABÁ;1;1081;2780;294;264;30
CUIABÁ;1;1082;2780;293;248;45
CUIABÁ;1;1083;2780;296;247;49
CUIABÁ;1;1084;2780;291;255;36
CUIABÁ;1;1085;2941;178;158;20
CUIABÁ;1;1086;2941;180;162;18
CUIABÁ;1;1087;2801;333;285;48
CUIABÁ;1;1088;2810;310;260;50
CUIABÁ;1;1089;2810;313;278;35
CUIABÁ;1;1090;2810;310;274;36
CUIABÁ;1;1091;2810;316;273;43
CUIABÁ;1;1092;2810;310;255;55
CUIABÁ;1;1093;2810;315;279;36
CUIABÁ;1;1094;2810;312;265;47
CUIABÁ;1;1095;2810;311;279;32
CUIABÁ;1;1096;2810;311;279;32
CUIABÁ;1;1097;2810;310;265;45
CUIABÁ;1;1098;2810;308;258;50
CUIABÁ;1;1099;2810;311;260;51
CUIABÁ;1;1100;2828;280;253;27
CUIABÁ;1;1104;2828;273;245;28
CUIABÁ;1;1105;2933;209;168;41
CUIABÁ;1;1106;2933;206;177;29
CUIABÁ;1;1107;2933;213;182;31
CUIABÁ;1;1108;2933;209;169;40
CUIABÁ;1;1109;2933;204;178;26
CUIABÁ;1;1110;2933;213;185;28
CUIABÁ;1;1111;2933;209;176;33
CUIABÁ;1;1112;2933;210;182;28
CUIABÁ;1;1113;2933;210;179;31
CUIABÁ;1;1114;2844;282;241;41
CUIABÁ;1;1115;2844;280;233;47
CUIABÁ;1;1116;2844;284;242;42
CUIABÁ;1;1117;2844;281;238;43
CUIABÁ;1;1118;2844;276;224;52
CUIABÁ;1;1119;2844;282;239;43
CUIABÁ;1;1120;2844;281;241;40
CUIABÁ;1;1121;2844;282;244;38
CUIABÁ;1;1122;2844;285;246;39
CUIABÁ;1;1123;2844;278;240;38
CUIABÁ;1;1124;2844;283;234;49
CUIABÁ;1;1125;2844;284;238;46
CUIABÁ;1;1126;2844;286;240;46
CUIABÁ;1;1127;2852;286;239;47
CUIABÁ;1;1128;2852;286;253;33
CUIABÁ;1;1129;2852;290;256;34
CUIABÁ;1;1130;2852;287;246;41
CUIABÁ;1;1131;2852;288;247;41
CUIABÁ;1;1133;2860;304;257;47
CUIABÁ;1;1135;2860;288;238;50
CUIABÁ;1;1136;2879;290;257;33
CUIABÁ;1;1137;2879;292;257;35
CUIABÁ;1;1138;2879;288;245;43
CUIABÁ;1;1139;2879;293;240;53
CUIABÁ;1;1140;2879;291;238;53
CUIABÁ;1;1141;2879;290;241;49
CUIABÁ;1;1142;2879;288;234;54
CUIABÁ;1;1143;2879;293;238;55
CUIABÁ;1;1144;2879;292;258;34
CUIABÁ;1;1145;2879;319;268;51
CUIABÁ;1;1146;2887;261;234;27
CUIABÁ;1;1147;2887;255;225;30
CUIABÁ;1;1148;2887;251;224;27
CUIABÁ;1;1149;2887;250;223;27
CUIABÁ;1;1150;2925;396;329;67
CUIABÁ;1;1151;2925;385;331;54
CUIABÁ;1;1152;2925;390;320;70
CUIABÁ;1;1153;2925;389;334;55
CUIABÁ;1;1154;2925;390;319;71
CUIABÁ;1;1155;2925;393;320;73
CUIABÁ;1;1156;2925;390;305;85
CUIABÁ;1;1158;2933;269;230;39
CUIABÁ;1;1159;2712;389;328;61
CUIABÁ;1;1160;2437;392;343;49
CUIABÁ;1;1161;2593;384;323;61
CUIABÁ;1;1162;1945;375;323;52
CUIABÁ;1;1163;2925;396;327;69
CUIABÁ;1;1164;2666;378;313;65
CUIABÁ;1;1165;2739;316;260;56
CUIABÁ;1;1166;2593;381;310;71
CUIABÁ;1;1167;2712;382;301;81
CUIABÁ;1;1168;2917;253;182;71
CUIABÁ;1;1169;2682;393;308;85
CUIABÁ;1;1170;1104;390;293;97
CUIABÁ;1;1171;2801;282;239;43
CUIABÁ;1;1172;1945;378;316;62
CUIABÁ;1;1173;2445;345;276;69
CUIABÁ;1;1174;2925;393;314;79
CUIABÁ;1;1175;2917;255;212;43
CUIABÁ;1;1176;2941;179;140;39
CUIABÁ;1;1177;2933;274;247;27
ACORIZAL;1;1178;1228;93;83;10
ACORIZAL;1;1178;1228;92;82;10
ACORIZAL;1;1179;1201;178;162;16
CUIABÁ;1;1180;2925;379;330;49
CUIABÁ;1;1182;2925;204;173;31
GUIRATINGA;2;2;1015;294;233;61
GUIRATINGA;2;3;1015;294;231;63
GUIRATINGA;2;5;1104;330;248;82
GUIRATINGA;2;6;1104;331;279;52
GUIRATINGA;2;7;1031;338;266;72
GUIRATINGA;2;8;1031;338;247;91
GUIRATINGA;2;9;1031;320;260;60
GUIRATINGA;2;10;1031;319;238;81
GUIRATINGA;2;11;1031;322;235;87
GUIRATINGA;2;12;1031;330;259;71
GUIRATINGA;2;13;1120;304;229;75
GUIRATINGA;2;15;1120;311;220;91
GUIRATINGA;2;16;1120;306;219;87
GUIRATINGA;2;17;1058;194;156;38
GUIRATINGA;2;19;1058;371;269;102
GUIRATINGA;2;20;1058;378;280;98
GUIRATINGA;2;22;1120;310;219;91
GUIRATINGA;2;24;1074;228;169;59
GUIRATINGA;2;25;1074;231;178;53
GUIRATINGA;2;26;1031;324;250;74
GUIRATINGA;2;27;1104;327;248;79
TESOURO;2;28;1015;272;194;78
TESOURO;2;29;1015;269;216;53
TESOURO;2;30;1015;266;193;73
TESOURO;2;31;1023;280;190;90
TESOURO;2;32;1023;289;199;90
TESOURO;2;33;1023;282;209;73
TESOURO;2;35;1031;344;265;79
GUIRATINGA;2;37;1015;293;244;49
GUIRATINGA;2;37;1015;292;243;49
TESOURO;2;38;1015;268;207;61
GUIRATINGA;2;39;1015;296;237;59
GUIRATINGA;2;41;1015;299;229;70
TESOURO;2;42;1015;267;222;45
GUIRATINGA;2;45;1104;327;258;69
GUIRATINGA;2;46;1104;337;261;76
GUIRATINGA;2;47;1104;325;260;65
SÃO JOSÉ DO POVO;2;150;1015;253;180;73
SÃO JOSÉ DO POVO;2;152;1031;282;202;80
SÃO JOSÉ DO POVO;2;153;1031;279;211;68
SÃO JOSÉ DO POVO;2;154;1031;277;212;65
SÃO JOSÉ DO POVO;2;155;1031;282;219;63
SÃO JOSÉ DO POVO;2;156;1031;280;216;64
SÃO JOSÉ DO POVO;2;157;1031;281;233;48
SÃO JOSÉ DO POVO;2;158;1031;277;218;59
SÃO JOSÉ DO POVO;2;159;1031;278;224;54
SÃO JOSÉ DO POVO;2;160;1031;281;199;82
TESOURO;2;161;1023;286;255;31
ROSÁRIO OESTE;3;46;1511;261;188;73
ROSÁRIO OESTE;3;48;1147;296;225;71
ROSÁRIO OESTE;3;49;1503;255;191;64
ROSÁRIO OESTE;3;52;1058;303;227;76
ROSÁRIO OESTE;3;53;1538;246;193;53
ROSÁRIO OESTE;3;54;1538;249;189;60
ROSÁRIO OESTE;3;55;1538;248;190;58
ROSÁRIO OESTE;3;57;1112;177;125;52
ROSÁRIO OESTE;3;58;1147;295;234;61
ROSÁRIO OESTE;3;59;1147;298;235;63
ROSÁRIO OESTE;3;60;1147;296;224;72
ROSÁRIO OESTE;3;61;1147;290;218;72
ROSÁRIO OESTE;3;62;1147;296;228;68
ROSÁRIO OESTE;3;64;1112;353;261;92
ROSÁRIO OESTE;3;69;1503;254;179;75
ROSÁRIO OESTE;3;70;1112;352;258;94
ROSÁRIO OESTE;3;72;1171;336;273;63
ROSÁRIO OESTE;3;76;1228;284;229;55
ROSÁRIO OESTE;3;78;1228;287;251;36
ROSÁRIO OESTE;3;82;1279;253;173;80
ROSÁRIO OESTE;3;86;1198;360;277;83
ROSÁRIO OESTE;3;88;1112;351;276;75
ROSÁRIO OESTE;3;91;1112;352;280;72
JANGADA;3;92;1201;272;220;52
JANGADA;3;93;1201;276;218;58
JANGADA;3;94;1155;394;296;98
JANGADA;3;97;1201;278;209;69
JANGADA;3;98;1201;274;208;66
JANGADA;3;99;1040;187;161;26
JANGADA;3;100;1058;267;227;40
JANGADA;3;101;1058;273;222;51
JANGADA;3;102;1066;370;308;62
JANGADA;3;103;1074;279;215;64
JANGADA;3;104;1058;268;208;60
ROSÁRIO OESTE;3;105;1317;382;304;78
JANGADA;3;106;1155;392;310;82
JANGADA;3;107;1112;272;236;36
JANGADA;3;108;1104;312;261;51
JANGADA;3;109;1112;269;229;40
JANGADA;3;111;1201;278;240;38
JANGADA;3;113;1201;273;224;49
ROSÁRIO OESTE;3;114;1511;320;250;70
ROSÁRIO OESTE;3;115;1538;248;179;69
ROSÁRIO OESTE;3;116;1538;247;190;57
ROSÁRIO OESTE;3;117;1325;274;195;79
ROSÁRIO OESTE;3;118;1350;183;149;34
ROSÁRIO OESTE;3;120;1341;294;238;56
ROSÁRIO OESTE;3;121;1473;347;236;111
ROSÁRIO OESTE;3;122;1325;275;204;71
ROSÁRIO OESTE;3;123;1058;297;235;62
JANGADA;3;124;1201;275;220;55
JANGADA;3;125;1155;395;323;72
ROSÁRIO OESTE;3;126;1414;290;217;73
ROSÁRIO OESTE;3;128;1392;259;217;42
ROSÁRIO OESTE;3;129;1392;259;219;40
ROSÁRIO OESTE;3;130;1538;244;171;73
ROSÁRIO OESTE;3;131;1414;295;232;63
NOBRES;3;133;1015;341;265;76
NOBRES;3;135;1015;340;269;71
NOBRES;3;136;1015;339;264;75
NOBRES;3;137;1015;173;138;35
NOBRES;3;141;1104;379;293;86
NOBRES;3;142;1104;190;151;39
NOBRES;3;144;1104;374;305;69
NOBRES;3;147;1031;287;234;53
NOBRES;3;148;1031;284;233;51
NOBRES;3;149;1031;284;230;54
NOBRES;3;150;1031;286;220;66
NOBRES;3;151;1031;281;217;64
NOBRES;3;152;1031;284;229;55
NOBRES;3;153;1031;282;227;55
NOBRES;3;154;1031;286;232;54
NOBRES;3;156;1104;376;311;65
NOBRES;3;157;1058;272;205;67
NOBRES;3;158;1058;271;214;57
NOBRES;3;159;1058;268;212;56
NOBRES;3;160;1058;275;216;59
NOBRES;3;161;1058;273;231;42
NOBRES;3;162;1058;274;212;62
NOBRES;3;163;1058;274;216;58
NOBRES;3;164;1058;265;207;58
NOBRES;3;165;1058;265;209;56
NOBRES;3;166;1066;303;233;70
NOBRES;3;167;1066;300;235;65
NOBRES;3;168;1066;302;241;61
NOBRES;3;169;1066;295;234;61
NOBRES;3;170;1074;387;311;76
NOBRES;3;171;1082;133;110;23
ROSÁRIO OESTE;3;174;1538;247;175;72
NOBRES;3;176;1090;375;280;95
JANGADA;3;178;1074;278;214;64
JANGADA;3;179;1040;192;152;40
NOBRES;3;180;1074;383;293;90
JANGADA;3;182;1201;314;261;53
ROSÁRIO OESTE;3;183;1511;174;136;38
NOBRES;3;184;1104;377;296;81
ROSÁRIO OESTE;3;185;1520;373;279;94
NOBRES;3;186;1104;379;300;79
NOBRES;3;189;1090;365;272;93
JANGADA;3;190;1201;275;212;63
ROSÁRIO OESTE;3;191;1414;289;214;75
ROSÁRIO OESTE;3;192;1058;302;234;68
JANGADA;3;193;1201;273;210;63
ROSÁRIO OESTE;3;194;1325;277;198;79
NOBRES;3;195;1090;362;272;90
NOBRES;3;196;1058;273;208;65
ROSÁRIO OESTE;3;197;1147;295;201;94
NOBRES;3;199;1090;180;130;50
POCONÉ;4;1;1090;345;264;81
POCONÉ;4;2;1104;203;166;37
POCONÉ;4;3;1295;343;262;81
POCONÉ;4;4;1295;351;270;81
POCONÉ;4;5;1295;347;261;86
POCONÉ;4;6;1104;398;286;112
POCONÉ;4;9;1058;347;272;75
POCONÉ;4;10;1058;350;286;64
POCONÉ;4;11;1058;350;286;64
POCONÉ;4;12;1074;297;242;55
POCONÉ;4;13;1082;225;181;44
POCONÉ;4;14;1082;219;183;36
POCONÉ;4;15;1104;398;299;99
POCONÉ;4;17;1082;222;166;56
POCONÉ;4;18;1295;342;266;76
POCONÉ;4;19;1090;344;246;98
POCONÉ;4;20;1287;371;293;78
POCONÉ;4;21;1287;371;279;92
POCONÉ;4;22;1155;282;200;82
POCONÉ;4;24;1155;228;176;52
POCONÉ;4;25;1155;222;175;47
POCONÉ;4;26;1104;398;302;96
POCONÉ;4;28;1236;294;236;58
POCONÉ;4;29;1236;198;142;56
POCONÉ;4;30;1155;226;191;35
POCONÉ;4;31;1155;226;178;48
POCONÉ;4;32;1155;224;180;44
POCONÉ;4;33;1155;227;183;44
POCONÉ;4;34;1252;391;272;119
POCONÉ;4;35;1252;388;281;107
POCONÉ;4;36;1252;394;272;122
POCONÉ;4;39;1090;338;254;84
POCONÉ;4;40;1287;372;304;68
POCONÉ;4;41;1295;349;266;83
POCONÉ;4;42;1295;346;267;79
POCONÉ;4;43;1309;307;247;60
POCONÉ;4;44;1309;304;246;58
POCONÉ;4;45;1082;221;186;35
POCONÉ;4;46;1082;222;179;43
POCONÉ;4;47;1309;308;234;74
POCONÉ;4;48;1333;341;230;111
POCONÉ;4;49;1333;345;247;98
POCONÉ;4;50;1333;345;232;113
POCONÉ;4;53;1546;305;259;46
POCONÉ;4;55;1287;373;311;62
POCONÉ;4;57;1155;225;189;36
POCONÉ;4;58;1252;386;313;73
POCONÉ;4;59;1074;297;228;69
POCONÉ;4;60;1082;220;171;49
POCONÉ;4;61;1104;396;287;109
POCONÉ;4;63;1414;378;296;82
POCONÉ;4;64;1082;221;175;46
POCONÉ;4;65;1295;347;244;103
POCONÉ;4;66;1333;340;237;103
POCONÉ;4;68;1082;222;186;36
POCONÉ;4;69;1392;348;258;90
POCONÉ;4;70;1384;237;183;54
POCONÉ;4;71;1376;272;191;81
POCONÉ;4;72;1368;269;216;53
POCONÉ;4;74;1392;351;257;94
POCONÉ;4;76;1074;296;224;72
POCONÉ;4;77;1376;270;217;53
POCONÉ;4;78;1155;226;180;46
POCONÉ;4;79;1430;353;277;76
POCONÉ;4;81;1252;388;284;104
POCONÉ;4;82;1333;344;256;88
POCONÉ;4;83;1465;305;229;76
POCONÉ;4;84;1430;352;271;81
POCONÉ;4;85;1473;233;164;69
POCONÉ;4;87;1252;389;289;100
POCONÉ;4;88;1333;343;245;98
POCONÉ;4;89;1058;347;247;100
POCONÉ;4;90;1031;362;288;74
POCONÉ;4;91;1252;390;279;111
POCONÉ;4;92;1082;220;171;49
POCONÉ;4;93;1368;168;113;55
POCONÉ;4;94;1031;361;256;105
POCONÉ;4;98;1554;143;123;20
NOVA MUTUM;5;86;1040;167;131;36
NOVA MUTUM;5;87;1066;381;291;90
NOVA MUTUM;5;88;1066;380;287;93
NOVA MUTUM;5;89;1066;389;316;73
NOVA MUTUM;5;90;1066;389;303;86
NOVA MUTUM;5;91;1066;386;303;83
NOVA MUTUM;5;92;1066;380;296;84
NOVA MUTUM;5;93;1066;383;288;95
NOVA MUTUM;5;94;1066;390;280;110
NOVA MUTUM;5;95;1066;383;276;107
NOVA MUTUM;5;96;1066;378;288;90
NOVA MUTUM;5;97;1090;389;292;97
NOVA MUTUM;5;98;1090;391;308;83
NOVA MUTUM;5;99;1090;385;303;82
NOVA MUTUM;5;100;1090;382;285;97
NOVA MUTUM;5;101;1090;385;299;86
NOVA MUTUM;5;102;1090;387;289;98
NOVA MUTUM;5;103;1090;388;298;90
NOVA MUTUM;5;104;1090;388;296;92
NOVA MUTUM;5;105;1090;381;279;102
NOVA MUTUM;5;106;1090;387;296;91
NOVA MUTUM;5;107;1104;294;241;53
NOVA MUTUM;5;108;1104;295;230;65
NOVA MUTUM;5;109;1112;379;294;85
NOVA MUTUM;5;110;1112;384;282;102
NOVA MUTUM;5;111;1112;385;290;95
NOVA MUTUM;5;112;1112;376;290;86
NOVA MUTUM;5;113;1112;379;294;85
NOVA MUTUM;5;114;1120;334;264;70
NOVA MUTUM;5;115;1120;334;260;74
NOVA MUTUM;5;116;1120;334;243;91
NOVA MUTUM;5;117;1139;390;311;79
NOVA MUTUM;5;118;1139;389;307;82
NOVA MUTUM;5;119;1139;383;292;91
NOVA MUTUM;5;120;1139;377;293;84
NOVA MUTUM;5;121;1139;382;292;90
NOVA MUTUM;5;122;1139;385;302;83
NOVA MUTUM;5;123;1139;378;297;81
NOVA MUTUM;5;124;1139;383;295;88
NOVA MUTUM;5;125;1139;383;282;101
NOVA MUTUM;5;126;1139;380;284;96
NOVA MUTUM;5;127;1139;378;280;98
NOVA MUTUM;5;128;1155;391;327;64
NOVA MUTUM;5;129;1155;394;321;73
NOVA MUTUM;5;130;1155;399;328;71
NOVA MUTUM;5;131;1155;398;324;74
NOVA MUTUM;5;132;1155;394;313;81
NOVA MUTUM;5;133;1155;395;325;70
NOVA MUTUM;5;134;1163;377;295;82
NOVA MUTUM;5;135;1163;380;283;97
NOVA MUTUM;5;136;1163;377;285;92
SANTA RITA DO TRIVELATO;5;137;1015;348;253;95
SANTA RITA DO TRIVELATO;5;138;1015;341;239;102
SANTA RITA DO TRIVELATO;5;139;1015;333;241;92
SANTA RITA DO TRIVELATO;5;140;1015;342;246;96
SANTA RITA DO TRIVELATO;5;141;1015;322;216;106
SANTA RITA DO TRIVELATO;5;142;1023;369;244;125
NOVA MUTUM;5;143;1180;366;282;84
NOVA MUTUM;5;144;1171;385;318;67
NOVA MUTUM;5;145;1198;389;285;104
NOVA MUTUM;5;146;1120;328;244;84
NOVA MUTUM;5;147;1198;384;290;94
NOVA MUTUM;5;148;1171;380;301;79
NOVA MUTUM;5;149;1198;385;291;94
NOVA MUTUM;5;150;1198;388;282;106
NOVA MUTUM;5;151;1198;389;285;104
NOVA MUTUM;5;152;1180;363;274;89
NOVA MUTUM;5;153;1171;388;309;79
NOVA MUTUM;5;154;1198;387;287;100
NOVA MUTUM;5;155;1120;333;254;79
NOVA MUTUM;5;156;1112;373;262;111
NOVA MUTUM;5;157;1210;380;308;72
NOVA MUTUM;5;158;1112;374;281;93
NOVA MUTUM;5;159;1120;333;256;77
NOVA MUTUM;5;160;1112;383;286;97
NOVA MUTUM;5;161;1210;390;315;75
NOVA MUTUM;5;162;1210;386;297;89
NOVA MUTUM;5;163;1112;382;285;97
NOVA MUTUM;5;164;1210;383;299;84
NOVA MUTUM;5;165;1210;384;287;97
NOVA MUTUM;5;166;1210;386;277;109
NOVA MUTUM;5;167;1180;365;243;122
NOVA MUTUM;5;168;1210;382;249;133
NOVA MUTUM;5;169;1210;377;247;130
NOVA MUTUM;5;170;1210;379;266;113
NOVA MUTUM;5;171;1210;380;266;114
NOVA MUTUM;5;172;1171;384;299;85
NOVA MUTUM;5;173;1244;433;306;127
NOVA MUTUM;5;174;1228;397;316;81
NOVA MUTUM;5;175;1236;215;171;44
SANTA RITA DO TRIVELATO;5;176;1015;283;219;64
NOVA MUTUM;5;177;1244;402;348;54
NOVA MUTUM;5;178;1112;308;263;45
NOVA MUTUM;5;179;1228;102;90;12
NOVA MUTUM;5;180;1171;141;124;17
CÁCERES;6;41;1015;276;197;79
CÁCERES;6;42;1015;275;191;84
CÁCERES;6;43;1015;257;187;70
CÁCERES;6;44;1015;259;189;70
CÁCERES;6;45;1015;260;195;65
CÁCERES;6;46;1015;258;180;78
CÁCERES;6;47;1015;261;188;73
CÁCERES;6;48;1015;273;197;76
CÁCERES;6;49;1015;265;194;71
CÁCERES;6;50;1023;415;280;135
CÁCERES;6;52;1023;413;281;132
CÁCERES;6;54;1023;413;306;107
CÁCERES;6;56;1023;203;146;57
CÁCERES;6;57;1015;268;181;87
CÁCERES;6;59;1015;269;187;82
CÁCERES;6;60;1015;258;196;62
CÁCERES;6;61;1058;356;252;104
CÁCERES;6;62;1058;346;265;81
CÁCERES;6;63;1058;375;275;100
CÁCERES;6;64;1058;352;249;103
CÁCERES;6;65;2160;326;233;93
CÁCERES;6;66;2160;328;243;85
CÁCERES;6;68;2160;172;130;42
CÁCERES;6;70;2178;292;220;72
CÁCERES;6;71;2178;306;222;84
CÁCERES;6;72;2178;300;225;75
CÁCERES;6;73;2178;311;208;103
CÁCERES;6;74;2178;306;200;106
CÁCERES;6;75;2178;305;216;89
CÁCERES;6;76;1120;300;216;84
CÁCERES;6;77;1120;288;213;75
CÁCERES;6;78;1090;380;271;109
CÁCERES;6;79;1090;378;271;107
CÁCERES;6;80;1090;375;276;99
CÁCERES;6;81;1090;375;278;97
CÁCERES;6;82;2178;301;219;82
CÁCERES;6;83;2178;301;233;68
CÁCERES;6;84;1112;383;270;113
CÁCERES;6;85;1112;381;276;105
CÁCERES;6;86;1112;382;269;113
CÁCERES;6;87;1112;383;281;102
CÁCERES;6;88;1112;386;269;117
CÁCERES;6;89;1120;283;210;73
CÁCERES;6;99;1147;365;267;98
CÁCERES;6;100;1147;374;274;100
CÁCERES;6;101;1147;377;277;100
CÁCERES;6;102;1147;377;275;102
CÁCERES;6;103;1155;401;270;131
CÁCERES;6;104;1155;411;288;123
CÁCERES;6;105;1155;399;271;128
CÁCERES;6;106;1155;399;277;122
CÁCERES;6;107;1163;314;222;92
CÁCERES;6;108;1163;331;219;112
CÁCERES;6;109;1163;328;213;115
CÁCERES;6;110;1163;333;225;108
CÁCERES;6;117;1198;321;214;107
CÁCERES;6;118;1198;321;212;109
CÁCERES;6;150;1015;255;197;58
CÁCERES;6;164;2186;418;300;118
CÁCERES;6;180;1694;331;225;106
CÁCERES;6;182;1198;295;207;88
CÁCERES;6;190;1090;357;270;87
CÁCERES;6;194;1112;376;295;81
CÁCERES;6;195;1090;369;271;98
CÁCERES;6;201;1155;406;276;130
CÁCERES;6;204;2178;296;225;71
CÁCERES;6;212;1163;316;231;85
CÁCERES;6;217;1619;376;276;100
CÁCERES;6;218;1627;402;284;118
CÁCERES;6;222;1660;244;197;47
CÁCERES;6;224;1015;264;189;75
CÁCERES;6;228;1090;362;271;91
CÁCERES;6;231;1058;352;258;94
CÁCERES;6;232;2178;301;242;59
CÁCERES;6;234;1090;361;283;78
CÁCERES;6;235;1678;390;295;95
CÁCERES;6;236;1686;394;306;88
CÁCERES;6;237;1155;385;276;109
CÁCERES;6;238;1147;356;286;70
CÁCERES;6;239;2178;301;233;68
CÁCERES;6;241;1694;265;150;115
CÁCERES;6;242;1660;250;172;78
CÁCERES;6;244;1163;305;222;83
CÁCERES;6;246;1732;368;246;122
CÁCERES;6;247;1627;385;288;97
CÁCERES;6;248;2178;290;220;70
CÁCERES;6;249;1090;368;286;82
CÁCERES;6;250;1740;195;124;71
CÁCERES;6;251;1686;405;298;107
CÁCERES;6;252;1619;371;280;91
CÁCERES;6;253;1660;243;193;50
CÁCERES;6;254;1694;265;148;117
CÁCERES;6;255;1678;403;309;94
CÁCERES;6;256;1694;208;121;87
CÁCERES;6;257;1767;416;312;104
CÁCERES;6;257;1767;413;311;102
CÁCERES;6;258;1147;354;259;95
CÁCERES;6;259;1163;318;237;81
CÁCERES;6;260;2178;299;221;78
CÁCERES;6;261;1767;414;318;96
CÁCERES;6;262;1090;369;275;94
CÁCERES;6;263;1058;348;262;86
CÁCERES;6;264;1686;387;291;96
CÁCERES;6;265;1740;318;226;92
CÁCERES;6;266;1619;375;273;102
CÁCERES;6;267;1775;306;216;90
CÁCERES;6;268;1775;302;227;75
CÁCERES;6;269;1775;312;217;95
CÁCERES;6;270;1775;305;220;85
CÁCERES;6;271;1775;295;219;76
CÁCERES;6;272;1775;304;215;89
CÁCERES;6;273;1775;298;227;71
CÁCERES;6;274;1775;302;227;75
CÁCERES;6;275;1775;298;220;78
CÁCERES;6;276;1775;282;227;55
CÁCERES;6;277;1775;291;228;63
CÁCERES;6;278;1783;411;280;131
CÁCERES;6;279;1783;408;279;129
CÁCERES;6;280;1783;424;294;130
CÁCERES;6;281;1783;399;296;103
CÁCERES;6;283;1791;308;200;108
CÁCERES;6;285;1813;372;250;122
CÁCERES;6;287;1813;144;81;63
CÁCERES;6;291;1830;261;174;87
CÁCERES;6;292;1830;243;183;60
CÁCERES;6;293;1830;246;174;72
CÁCERES;6;294;1830;241;177;64
CÁCERES;6;297;1830;456;308;148
CÁCERES;6;298;1970;414;299;115
CÁCERES;6;299;1872;348;233;115
CÁCERES;6;300;1872;350;249;101
CÁCERES;6;301;1872;324;246;78
CÁCERES;6;303;1872;341;245;96
CÁCERES;6;304;1872;328;240;88
CÁCERES;6;305;1872;341;236;105
CÁCERES;6;306;1880;286;191;95
CÁCERES;6;307;1880;278;198;80
CÁCERES;6;308;1880;280;201;79
CÁCERES;6;309;1880;266;196;70
CÁCERES;6;310;1880;262;197;65
CÁCERES;6;311;1880;258;212;46
CÁCERES;6;312;1880;260;200;60
CÁCERES;6;313;1830;240;163;77
CÁCERES;6;316;1929;202;133;69
CÁCERES;6;317;1937;411;300;111
CÁCERES;6;319;1937;405;296;109
CÁCERES;6;320;1937;408;296;112
CÁCERES;6;321;1961;268;195;73
CÁCERES;6;325;1996;400;286;114
CÁCERES;6;326;1996;388;286;102
CÁCERES;6;327;2003;317;222;95
CÁCERES;6;329;2003;312;222;90
CÁCERES;6;330;2020;357;251;106
CÁCERES;6;331;2020;365;278;87
CÁCERES;6;332;2020;356;270;86
CÁCERES;6;334;2054;390;266;124
CÁCERES;6;336;2054;391;288;103
CÁCERES;6;337;2054;397;291;106
CÁCERES;6;338;2054;406;298;108
CÁCERES;6;339;2062;248;176;72
CÁCERES;6;341;2097;356;228;128
CÁCERES;6;342;1775;298;232;66
CÁCERES;6;343;1775;303;213;90
CÁCERES;6;344;2119;247;202;45
CÁCERES;6;345;1961;268;158;110
CÁCERES;6;346;2119;233;182;51
CÁCERES;6;361;1627;377;284;93
CÁCERES;6;363;2151;195;129;66
CÁCERES;6;364;2054;388;274;114
CÁCERES;6;365;2097;359;241;118
CÁCERES;6;366;1163;319;208;111
CÁCERES;6;368;1155;384;271;113
CÁCERES;6;369;2178;296;218;78
CÁCERES;6;370;1147;360;255;105
CÁCERES;6;371;1783;398;270;128
CÁCERES;6;372;2178;293;216;77
CÁCERES;6;373;2186;406;302;104
CÁCERES;6;374;1767;407;309;98
CÁCERES;6;376;1686;397;301;96
CÁCERES;6;377;2062;228;181;47
CÁCERES;6;379;1996;369;259;110
CÁCERES;6;380;1678;411;290;121
CÁCERES;6;381;1767;418;316;102
CÁCERES;6;382;1783;381;272;109
CÁCERES;6;383;1112;338;230;108
CÁCERES;6;384;2003;361;269;92
CÁCERES;6;385;2097;319;221;98
CÁCERES;6;386;1686;368;265;103
CÁCERES;6;387;2178;260;204;56
CÁCERES;6;388;1619;341;261;80
CÁCERES;6;389;1678;367;283;84
CÁCERES;6;390;1937;367;271;96
CÁCERES;6;391;2178;265;193;72
CÁCERES;6;392;1015;450;308;142
CÁCERES;6;393;2178;260;188;72
CÁCERES;6;394;1767;376;291;85
CÁCERES;6;396;1147;333;259;74
CÁCERES;6;398;2186;431;326;105
CÁCERES;6;399;1058;314;234;80
CÁCERES;6;400;1112;338;251;87
ALTO PARAGUAI;7;1;1023;224;178;46
ALTO PARAGUAI;7;2;1023;224;170;54
ALTO PARAGUAI;7;3;1023;221;170;51
ALTO PARAGUAI;7;4;1023;223;170;53
ALTO PARAGUAI;7;5;1023;221;184;37
ALTO PARAGUAI;7;6;1023;224;175;49
ALTO PARAGUAI;7;9;1210;282;202;80
ALTO PARAGUAI;7;11;1058;382;277;105
ALTO PARAGUAI;7;13;1058;247;195;52
ALTO PARAGUAI;7;16;1058;358;282;76
ALTO PARAGUAI;7;17;1058;363;247;116
ALTO PARAGUAI;7;19;1074;200;156;44
ALTO PARAGUAI;7;20;1074;200;148;52
ALTO PARAGUAI;7;23;1244;252;197;55
ALTO PARAGUAI;7;24;1244;256;198;58
DIAMANTINO;7;27;1422;156;121;35
DIAMANTINO;7;28;1058;394;291;103
DIAMANTINO;7;29;1058;331;252;79
DIAMANTINO;7;31;1040;375;295;80
DIAMANTINO;7;33;1058;397;300;97
DIAMANTINO;7;34;1058;396;296;100
DIAMANTINO;7;38;1350;313;245;68
DIAMANTINO;7;39;1350;311;228;83
DIAMANTINO;7;40;1422;296;228;68
DIAMANTINO;7;42;1040;386;296;90
DIAMANTINO;7;43;1422;293;226;67
DIAMANTINO;7;45;1120;342;270;72
DIAMANTINO;7;46;1120;344;261;83
DIAMANTINO;7;47;1120;348;268;80
DIAMANTINO;7;48;1139;318;233;85
DIAMANTINO;7;49;1139;321;226;95
DIAMANTINO;7;50;1139;315;228;87
DIAMANTINO;7;51;1147;280;210;70
DIAMANTINO;7;52;1147;285;228;57
DIAMANTINO;7;53;1147;282;233;49
DIAMANTINO;7;80;1295;170;133;37
DIAMANTINO;7;81;1309;342;257;85
DIAMANTINO;7;82;1350;313;240;73
DIAMANTINO;7;84;1040;384;292;92
ALTO PARAGUAI;7;114;1074;196;162;34
ALTO PARAGUAI;7;123;1244;255;196;59
ALTO PARAGUAI;7;125;1120;182;138;44
ALTO PARAGUAI;7;126;1244;255;203;52
DIAMANTINO;7;131;1155;251;199;52
DIAMANTINO;7;145;1309;338;255;83
ALTO PARAGUAI;7;155;1252;247;174;73
DIAMANTINO;7;160;1147;281;233;48
DIAMANTINO;7;163;1368;208;160;48
DIAMANTINO;7;166;1309;342;264;78
DIAMANTINO;7;171;1163;276;207;69
DIAMANTINO;7;179;1309;341;262;79
DIAMANTINO;7;193;1040;385;299;86
DIAMANTINO;7;197;1040;379;302;77
DIAMANTINO;7;201;1414;267;209;58
DIAMANTINO;7;201;1414;265;207;58
DIAMANTINO;7;202;1422;294;222;72
DIAMANTINO;7;207;1368;202;155;47
DIAMANTINO;7;208;1368;206;150;56
DIAMANTINO;7;209;1368;206;156;50
DIAMANTINO;7;210;1309;346;255;91
DIAMANTINO;7;212;1147;282;220;62
DIAMANTINO;7;224;1163;283;215;68
DIAMANTINO;7;225;1139;310;218;92
DIAMANTINO;7;230;1392;237;187;50
ALTO PARAGUAI;7;231;1210;279;183;96
DIAMANTINO;7;240;1309;343;252;91
DIAMANTINO;7;244;1392;262;184;78
DIAMANTINO;7;248;1147;283;223;60
DIAMANTINO;7;251;1120;343;268;75
ALTO PARAGUAI;7;254;1228;161;129;32
ALTO PARAGUAI;7;255;1201;332;250;82
ALTO PARAGUAI;7;257;1252;344;261;83
DIAMANTINO;7;258;1309;337;241;96
DIAMANTINO;7;259;1309;304;230;74
DIAMANTINO;7;260;1120;306;241;65
DIAMANTINO;7;261;1155;211;161;50
DIAMANTINO;7;264;1309;303;219;84
DIAMANTINO;7;265;1147;252;203;49
DIAMANTINO;7;267;1139;279;201;78
ALTO ARAGUAIA;8;1;1074;251;192;59
ALTO ARAGUAIA;8;2;1074;255;185;70
ALTO ARAGUAIA;8;3;1040;207;145;62
ALTO ARAGUAIA;8;4;1040;209;167;42
ALTO ARAGUAIA;8;5;1074;260;206;54
ALTO ARAGUAIA;8;6;1040;212;156;56
ALTO ARAGUAIA;8;7;1040;210;158;52
ALTO ARAGUAIA;8;8;1040;209;164;45
ALTO ARAGUAIA;8;9;1040;208;159;49
ALTO ARAGUAIA;8;10;1040;208;163;45
ALTO ARAGUAIA;8;11;1082;284;210;74
ALTO ARAGUAIA;8;12;1082;297;211;86
ALTO ARAGUAIA;8;13;1074;270;190;80
ALTO ARAGUAIA;8;14;1074;255;194;61
ALTO ARAGUAIA;8;15;1074;257;191;66
ALTO ARAGUAIA;8;16;1074;254;194;60
ALTO ARAGUAIA;8;17;1074;248;186;62
ALTO ARAGUAIA;8;17;1074;246;184;62
ALTO ARAGUAIA;8;19;1082;298;232;66
ALTO ARAGUAIA;8;20;1082;283;221;62
ALTO ARAGUAIA;8;20;1082;282;220;62
ALTO ARAGUAIA;8;21;1082;288;224;64
ALTO TAQUARI;8;24;1015;287;218;69
ALTO TAQUARI;8;25;1015;284;211;73
ALTO TAQUARI;8;26;1015;273;218;55
ALTO TAQUARI;8;26;1015;272;217;55
ALTO TAQUARI;8;27;1015;281;210;71
ALTO TAQUARI;8;28;1015;290;211;79
ALTO ARAGUAIA;8;29;1120;222;152;70
ARAGUAINHA;8;33;1015;207;163;44
ARAGUAINHA;8;34;1015;210;178;32
ARAGUAINHA;8;35;1015;206;161;45
ARAGUAINHA;8;36;1015;209;160;49
PONTE BRANCA;8;37;1040;215;165;50
PONTE BRANCA;8;38;1040;204;156;48
PONTE BRANCA;8;39;1040;204;149;55
PONTE BRANCA;8;40;1040;210;165;45
PONTE BRANCA;8;41;1040;219;161;58
PONTE BRANCA;8;42;1040;239;178;61
PONTE BRANCA;8;43;1040;214;166;48
PONTE BRANCA;8;47;1040;203;164;39
PONTE BRANCA;8;47;1040;202;163;39
PONTE BRANCA;8;48;1040;211;155;56
ALTO TAQUARI;8;49;1015;276;210;66
ALTO TAQUARI;8;51;1015;276;206;70
ARAGUAINHA;8;52;1015;209;171;38
ALTO ARAGUAIA;8;54;1201;318;224;94
ALTO TAQUARI;8;58;1015;273;215;58
ALTO ARAGUAIA;8;59;1147;308;240;68
ALTO ARAGUAIA;8;60;1163;337;252;85
ALTO ARAGUAIA;8;61;1171;305;231;74
ALTO TAQUARI;8;62;1023;362;275;87
ALTO ARAGUAIA;8;63;1147;308;204;104
ALTO TAQUARI;8;64;1023;349;268;81
ALTO TAQUARI;8;65;1023;362;255;107
ALTO ARAGUAIA;8;66;1201;310;225;85
ALTO ARAGUAIA;8;67;1198;139;106;33
ALTO ARAGUAIA;8;67;1198;138;105;33
ALTO ARAGUAIA;8;68;1082;290;215;75
ALTO TAQUARI;8;69;1023;357;271;86
ALTO ARAGUAIA;8;70;1147;307;205;102
ALTO TAQUARI;8;71;1023;367;246;121
ALTO TAQUARI;8;72;1023;355;264;91
ALTO ARAGUAIA;8;73;1171;308;240;68
ALTO ARAGUAIA;8;95;1163;347;261;86
ALTO ARAGUAIA;8;96;1082;292;205;87
ALTO ARAGUAIA;8;97;1147;305;227;78
ALTO ARAGUAIA;8;98;1082;291;206;85
ALTO TAQUARI;8;100;1015;285;196;89
ALTO TAQUARI;8;101;1040;303;236;67
ALTO ARAGUAIA;8;103;1082;295;199;96
ALTO ARAGUAIA;8;104;1040;209;148;61
ALTO TAQUARI;8;105;1040;314;217;97
ALTO ARAGUAIA;8;106;1147;311;228;83
ALTO TAQUARI;8;107;1040;307;227;80
ALTO TAQUARI;8;108;1040;309;216;93
ALTO ARAGUAIA;8;109;1147;315;198;117
ALTO TAQUARI;8;110;1015;286;211;75
ALTO ARAGUAIA;8;111;1171;293;217;76
ALTO ARAGUAIA;8;112;1147;301;200;101
ALTO ARAGUAIA;8;113;1163;318;234;84
ALTO TAQUARI;8;115;1015;275;211;64
ALTO ARAGUAIA;8;116;1147;299;197;102
ALTO TAQUARI;8;117;1040;308;229;79
ALTO ARAGUAIA;8;118;1147;280;201;79
ALTO TAQUARI;8;119;1040;307;224;83
ALTO TAQUARI;8;120;1040;310;217;93
ALTO ARAGUAIA;8;121;1201;284;220;64
BARRA DO GARÇAS;9;1;1031;335;231;104
BARRA DO GARÇAS;9;3;1031;327;249;78
BARRA DO GARÇAS;9;4;1023;340;238;102
BARRA DO GARÇAS;9;7;1023;336;252;84
BARRA DO GARÇAS;9;11;1031;337;260;77
BARRA DO GARÇAS;9;13;1031;333;228;105
BARRA DO GARÇAS;9;15;1031;326;246;80
BARRA DO GARÇAS;9;16;1040;397;274;123
BARRA DO GARÇAS;9;16;1040;396;273;123
BARRA DO GARÇAS;9;19;1040;298;210;88
BARRA DO GARÇAS;9;20;1040;279;195;84
BARRA DO GARÇAS;9;29;1066;341;229;112
BARRA DO GARÇAS;9;29;1066;339;227;112
BARRA DO GARÇAS;9;31;1066;301;222;79
BARRA DO GARÇAS;9;33;1066;320;235;85
BARRA DO GARÇAS;9;35;1023;336;235;101
BARRA DO GARÇAS;9;38;1023;325;220;105
BARRA DO GARÇAS;9;42;1031;338;232;106
BARRA DO GARÇAS;9;44;1066;304;212;92
BARRA DO GARÇAS;9;46;1066;294;201;93
BARRA DO GARÇAS;9;48;1066;310;201;109
BARRA DO GARÇAS;9;50;1031;342;246;96
BARRA DO GARÇAS;9;52;1406;328;249;79
BARRA DO GARÇAS;9;55;1031;340;241;99
BARRA DO GARÇAS;9;57;1031;290;214;76
BARRA DO GARÇAS;9;58;1023;314;235;79
BARRA DO GARÇAS;9;58;1023;312;233;79
BARRA DO GARÇAS;9;64;1023;221;165;56
BARRA DO GARÇAS;9;64;1023;220;164;56
BARRA DO GARÇAS;9;67;1040;391;285;106
BARRA DO GARÇAS;9;69;1406;375;245;130
BARRA DO GARÇAS;9;71;1066;314;235;79
BARRA DO GARÇAS;9;75;1040;384;278;106
BARRA DO GARÇAS;9;78;1040;280;206;74
BARRA DO GARÇAS;9;84;1406;330;262;68
BARRA DO GARÇAS;9;85;1279;369;285;84
BARRA DO GARÇAS;9;86;1279;356;275;81
BARRA DO GARÇAS;9;87;1279;366;263;103
BARRA DO GARÇAS;9;88;1279;367;270;97
BARRA DO GARÇAS;9;89;1279;360;274;86
BARRA DO GARÇAS;9;90;1287;384;274;110
BARRA DO GARÇAS;9;90;1287;383;273;110
BARRA DO GARÇAS;9;92;1287;381;269;112
BARRA DO GARÇAS;9;94;1287;384;263;121
BARRA DO GARÇAS;9;96;1287;385;255;130
BARRA DO GARÇAS;9;98;1287;380;273;107
BARRA DO GARÇAS;9;100;1287;381;271;110
BARRA DO GARÇAS;9;102;1287;388;279;109
BARRA DO GARÇAS;9;104;1287;382;263;119
BARRA DO GARÇAS;9;106;1287;341;226;115
BARRA DO GARÇAS;9;107;1287;199;148;51
BARRA DO GARÇAS;9;109;1287;221;134;87
BARRA DO GARÇAS;9;110;1414;234;171;63
BARRA DO GARÇAS;9;111;1414;235;170;65
BARRA DO GARÇAS;9;112;1414;237;162;75
BARRA DO GARÇAS;9;113;1414;234;161;73
BARRA DO GARÇAS;9;114;1295;353;240;113
BARRA DO GARÇAS;9;116;1295;354;258;96
BARRA DO GARÇAS;9;118;1295;345;244;101
BARRA DO GARÇAS;9;120;1295;353;245;108
BARRA DO GARÇAS;9;122;1295;339;241;98
BARRA DO GARÇAS;9;124;1295;174;124;50
BARRA DO GARÇAS;9;125;1309;366;273;93
BARRA DO GARÇAS;9;127;1309;372;269;103
BARRA DO GARÇAS;9;352;1058;391;293;98
BARRA DO GARÇAS;9;353;1163;407;321;86
BARRA DO GARÇAS;9;354;1309;370;279;91
BARRA DO GARÇAS;9;356;1333;320;238;82
BARRA DO GARÇAS;9;357;1040;267;199;68
BARRA DO GARÇAS;9;358;1163;418;325;93
BARRA DO GARÇAS;9;359;1058;385;282;103
BARRA DO GARÇAS;9;363;1163;420;325;95
BARRA DO GARÇAS;9;366;1309;176;134;42
BARRA DO GARÇAS;9;368;1333;318;247;71
BARRA DO GARÇAS;9;369;1058;389;293;96
BARRA DO GARÇAS;9;371;1163;413;294;119
PONTAL DO ARAGUAIA;9;373;1015;363;262;101
PONTAL DO ARAGUAIA;9;374;1015;354;271;83
PONTAL DO ARAGUAIA;9;375;1015;368;280;88
PONTAL DO ARAGUAIA;9;376;1023;241;187;54
PONTAL DO ARAGUAIA;9;377;1023;245;192;53
PONTAL DO ARAGUAIA;9;378;1023;250;183;67
PONTAL DO ARAGUAIA;9;379;1023;255;200;55
PONTAL DO ARAGUAIA;9;380;1023;255;180;75
PONTAL DO ARAGUAIA;9;381;1040;262;205;57
PONTAL DO ARAGUAIA;9;382;1040;258;200;58
PONTAL DO ARAGUAIA;9;383;1066;260;211;49
PONTAL DO ARAGUAIA;9;384;1023;246;188;58
PONTAL DO ARAGUAIA;9;385;1023;245;194;51
ARAGUAIANA;9;386;1015;294;235;59
ARAGUAIANA;9;387;1015;288;208;80
ARAGUAIANA;9;388;1015;293;212;81
ARAGUAIANA;9;389;1015;291;227;64
ARAGUAIANA;9;390;1023;366;259;107
ARAGUAIANA;9;391;1023;377;257;120
ARAGUAIANA;9;392;1023;372;280;92
ARAGUAIANA;9;393;1023;372;270;102
ARAGUAIANA;9;394;1023;367;271;96
BARRA DO GARÇAS;9;395;1589;326;242;84
PONTAL DO ARAGUAIA;9;396;1015;352;250;102
PONTAL DO ARAGUAIA;9;397;1015;340;280;60
PONTAL DO ARAGUAIA;9;398;1015;342;268;74
BARRA DO GARÇAS;9;399;1058;346;261;85
BARRA DO GARÇAS;9;400;1066;290;212;78
BARRA DO GARÇAS;9;402;1066;291;214;77
BARRA DO GARÇAS;9;404;1066;291;211;80
BARRA DO GARÇAS;9;406;1066;310;206;104
BARRA DO GARÇAS;9;408;1449;215;159;56
BARRA DO GARÇAS;9;409;1449;223;159;64
BARRA DO GARÇAS;9;410;1449;221;157;64
BARRA DO GARÇAS;9;411;1457;231;163;68
BARRA DO GARÇAS;9;413;1457;229;165;64
BARRA DO GARÇAS;9;415;1465;397;266;131
BARRA DO GARÇAS;9;416;1465;394;275;119
BARRA DO GARÇAS;9;417;1465;383;260;123
BARRA DO GARÇAS;9;418;1465;389;274;115
BARRA DO GARÇAS;9;419;1465;382;261;121
BARRA DO GARÇAS;9;420;1473;320;230;90
BARRA DO GARÇAS;9;421;1473;331;221;110
BARRA DO GARÇAS;9;422;1473;335;247;88
BARRA DO GARÇAS;9;423;1473;335;253;82
BARRA DO GARÇAS;9;424;1473;347;259;88
BARRA DO GARÇAS;9;425;1473;360;259;101
BARRA DO GARÇAS;9;426;1481;380;270;110
BARRA DO GARÇAS;9;427;1481;378;284;94
BARRA DO GARÇAS;9;428;1481;382;295;87
BARRA DO GARÇAS;9;429;1481;388;280;108
BARRA DO GARÇAS;9;430;1490;331;226;105
BARRA DO GARÇAS;9;431;1490;324;239;85
BARRA DO GARÇAS;9;432;1490;299;197;102
BARRA DO GARÇAS;9;433;1511;396;294;102
BARRA DO GARÇAS;9;434;1520;134;79;55
BARRA DO GARÇAS;9;436;1538;356;259;97
BARRA DO GARÇAS;9;437;1538;327;234;93
BARRA DO GARÇAS;9;438;1538;347;232;115
BARRA DO GARÇAS;9;439;1562;435;282;153
BARRA DO GARÇAS;9;440;1562;438;284;154
BARRA DO GARÇAS;9;441;1562;435;296;139
BARRA DO GARÇAS;9;442;1562;431;283;148
BARRA DO GARÇAS;9;443;1562;377;249;128
BARRA DO GARÇAS;9;444;1589;375;262;113
BARRA DO GARÇAS;9;445;1589;369;258;111
BARRA DO GARÇAS;9;446;1589;365;258;107
BARRA DO GARÇAS;9;447;1589;338;240;98
BARRA DO GARÇAS;9;448;1597;424;321;103
BARRA DO GARÇAS;9;448;1597;422;319;103
BARRA DO GARÇAS;9;449;1597;418;314;104
BARRA DO GARÇAS;9;450;1597;427;315;112
BARRA DO GARÇAS;9;451;1597;390;305;85
BARRA DO GARÇAS;9;452;1600;396;275;121
BARRA DO GARÇAS;9;453;1600;401;282;119
BARRA DO GARÇAS;9;454;1600;394;271;123
BARRA DO GARÇAS;9;455;1600;390;268;122
BARRA DO GARÇAS;9;456;1600;391;288;103
BARRA DO GARÇAS;9;457;1600;384;277;107
BARRA DO GARÇAS;9;458;1600;402;281;121
BARRA DO GARÇAS;9;459;1600;397;276;121
BARRA DO GARÇAS;9;460;1627;301;203;98
BARRA DO GARÇAS;9;460;1627;300;202;98
BARRA DO GARÇAS;9;461;1627;130;89;41
GENERAL CARNEIRO;9;462;1015;352;248;104
GENERAL CARNEIRO;9;465;1015;345;263;82
GENERAL CARNEIRO;9;468;1015;347;258;89
GENERAL CARNEIRO;9;471;1015;343;261;82
GENERAL CARNEIRO;9;474;1015;238;177;61
GENERAL CARNEIRO;9;474;1015;237;176;61
GENERAL CARNEIRO;9;476;1015;270;207;63
GENERAL CARNEIRO;9;478;1040;215;158;57
GENERAL CARNEIRO;9;479;1040;213;147;66
GENERAL CARNEIRO;9;480;1040;207;152;55
GENERAL CARNEIRO;9;481;1058;274;209;65
GENERAL CARNEIRO;9;482;1066;291;244;47
GENERAL CARNEIRO;9;483;1066;292;236;56
GENERAL CARNEIRO;9;483;1066;291;235;56
GENERAL CARNEIRO;9;484;1074;375;274;101
GENERAL CARNEIRO;9;486;1074;376;286;90
GENERAL CARNEIRO;9;486;1074;375;285;90
RIBEIRÃOZINHO;9;488;1015;377;302;75
RIBEIRÃOZINHO;9;489;1015;375;298;77
RIBEIRÃOZINHO;9;490;1015;376;292;84
RIBEIRÃOZINHO;9;491;1015;377;308;69
RIBEIRÃOZINHO;9;492;1015;378;289;89
RIBEIRÃOZINHO;9;493;1023;221;185;36
TORIXORÉU;9;494;1015;311;251;60
TORIXORÉU;9;496;1015;312;239;73
TORIXORÉU;9;498;1015;309;246;63
TORIXORÉU;9;500;1015;310;223;87
TORIXORÉU;9;502;1015;157;121;36
TORIXORÉU;9;503;1023;324;264;60
TORIXORÉU;9;506;1023;318;236;82
TORIXORÉU;9;509;1023;315;258;57
TORIXORÉU;9;512;1023;320;260;60
TORIXORÉU;9;515;1066;188;161;27
TORIXORÉU;9;517;1074;283;220;63
TORIXORÉU;9;521;1074;282;222;60
BARRA DO GARÇAS;9;525;1562;384;255;129
BARRA DO GARÇAS;9;526;1163;391;312;79
BARRA DO GARÇAS;9;527;1465;348;236;112
BARRA DO GARÇAS;9;528;1589;329;262;67
BARRA DO GARÇAS;9;529;1473;377;294;83
BARRA DO GARÇAS;9;530;1333;295;219;76
BARRA DO GARÇAS;9;532;1473;373;298;75
BARRA DO GARÇAS;9;533;1597;388;301;87
BARRA DO GARÇAS;9;534;1562;381;257;124
BARRA DO GARÇAS;9;535;1473;170;121;49
PONTAL DO ARAGUAIA;9;536;1015;306;253;53
BARRA DO GARÇAS;9;537;1643;193;160;33
BARRA DO GARÇAS;9;538;1481;208;174;34
ARAGUAIANA;9;539;1023;153;120;33
BARRA DO GARÇAS;9;540;1562;359;282;77
RONDONÓPOLIS;10;1;1015;393;326;67
RONDONÓPOLIS;10;1;1015;312;253;59
RONDONÓPOLIS;10;2;1015;392;314;78
RONDONÓPOLIS;10;2;1015;307;241;66
RONDONÓPOLIS;10;3;1015;263;211;52
RONDONÓPOLIS;10;4;1015;268;208;60
RONDONÓPOLIS;10;5;1015;268;224;44
RONDONÓPOLIS;10;6;1023;386;296;90
RONDONÓPOLIS;10;8;1023;253;171;82
RONDONÓPOLIS;10;9;1023;253;187;66
RONDONÓPOLIS;10;10;1023;249;189;60
RONDONÓPOLIS;10;11;1023;250;191;59
RONDONÓPOLIS;10;12;1023;253;185;68
RONDONÓPOLIS;10;13;1023;246;184;62
RONDONÓPOLIS;10;14;1023;246;188;58
RONDONÓPOLIS;10;17;1031;225;180;45
RONDONÓPOLIS;10;18;1031;218;162;56
RONDONÓPOLIS;10;19;1031;211;156;55
RONDONÓPOLIS;10;20;1031;222;167;55
RONDONÓPOLIS;10;21;1031;215;161;54
RONDONÓPOLIS;10;22;1031;218;171;47
RONDONÓPOLIS;10;23;1031;220;170;50
RONDONÓPOLIS;10;24;1031;214;158;56
RONDONÓPOLIS;10;25;1031;220;162;58
RONDONÓPOLIS;10;26;1040;245;193;52
RONDONÓPOLIS;10;27;1040;248;202;46
RONDONÓPOLIS;10;28;1040;244;197;47
RONDONÓPOLIS;10;29;1040;243;193;50
RONDONÓPOLIS;10;30;1040;249;200;49
RONDONÓPOLIS;10;31;1040;248;198;50
RONDONÓPOLIS;10;32;1040;242;205;37
RONDONÓPOLIS;10;34;1040;245;200;45
RONDONÓPOLIS;10;35;1058;375;295;80
RONDONÓPOLIS;10;36;1023;249;175;74
RONDONÓPOLIS;10;38;1201;312;260;52
RONDONÓPOLIS;10;40;1201;309;244;65
RONDONÓPOLIS;10;43;1040;247;196;51
RONDONÓPOLIS;10;44;1562;226;180;46
RONDONÓPOLIS;10;44;1562;225;179;46
RONDONÓPOLIS;10;45;1562;220;163;57
RONDONÓPOLIS;10;74;1155;346;256;90
RONDONÓPOLIS;10;75;1155;349;269;80
RONDONÓPOLIS;10;76;1155;339;271;68
RONDONÓPOLIS;10;77;1155;344;263;81
RONDONÓPOLIS;10;78;1155;347;251;96
RONDONÓPOLIS;10;79;1155;344;270;74
RONDONÓPOLIS;10;80;1155;341;266;75
RONDONÓPOLIS;10;81;1163;348;252;96
RONDONÓPOLIS;10;82;1163;352;267;85
RONDONÓPOLIS;10;94;1562;222;166;56
RONDONÓPOLIS;10;96;1201;309;249;60
RONDONÓPOLIS;10;138;1155;342;257;85
RONDONÓPOLIS;10;151;1333;385;311;74
RONDONÓPOLIS;10;152;1333;372;302;70
RONDONÓPOLIS;10;153;1333;379;307;72
RONDONÓPOLIS;10;160;1538;395;289;106
RONDONÓPOLIS;10;169;1449;243;196;47
RONDONÓPOLIS;10;174;1481;354;280;74
RONDONÓPOLIS;10;174;1481;353;279;74
RONDONÓPOLIS;10;175;1481;349;257;92
RONDONÓPOLIS;10;176;1490;329;267;62
RONDONÓPOLIS;10;197;1023;372;287;85
RONDONÓPOLIS;10;214;1163;350;259;91
RONDONÓPOLIS;10;215;1562;224;172;52
RONDONÓPOLIS;10;219;1562;217;162;55
RONDONÓPOLIS;10;227;1511;368;292;76
RONDONÓPOLIS;10;227;1511;367;292;75
RONDONÓPOLIS;10;228;1511;364;289;75
RONDONÓPOLIS;10;230;1031;217;167;50
RONDONÓPOLIS;10;236;1163;347;264;83
RONDONÓPOLIS;10;242;1554;390;327;63
RONDONÓPOLIS;10;242;1554;176;143;33
RONDONÓPOLIS;10;246;1163;351;267;84
RONDONÓPOLIS;10;253;1511;361;269;92
RONDONÓPOLIS;10;257;1023;185;139;46
RONDONÓPOLIS;10;258;1554;388;314;74
RONDONÓPOLIS;10;258;1554;272;214;58
RONDONÓPOLIS;10;264;1040;245;193;52
RONDONÓPOLIS;10;265;1023;249;181;68
RONDONÓPOLIS;10;267;1155;343;287;56
RONDONÓPOLIS;10;268;1511;369;286;83
RONDONÓPOLIS;10;269;1015;268;214;54
RONDONÓPOLIS;10;270;1040;244;206;38
RONDONÓPOLIS;10;271;1023;242;175;67
RONDONÓPOLIS;10;272;1333;379;317;62
RONDONÓPOLIS;10;273;1511;363;279;84
RONDONÓPOLIS;10;276;1511;362;286;76
RONDONÓPOLIS;10;277;1155;346;260;86
RONDONÓPOLIS;10;278;1759;396;303;93
RONDONÓPOLIS;10;279;1481;350;276;74
RONDONÓPOLIS;10;280;1449;240;187;53
RONDONÓPOLIS;10;281;1767;330;258;72
RONDONÓPOLIS;10;282;1783;362;265;97
RONDONÓPOLIS;10;283;1775;385;285;100
RONDONÓPOLIS;10;284;1490;328;239;89
RONDONÓPOLIS;10;285;1163;346;255;91
RONDONÓPOLIS;10;286;1775;387;284;103
RONDONÓPOLIS;10;287;1759;378;263;115
RONDONÓPOLIS;10;288;1538;390;296;94
RONDONÓPOLIS;10;290;1783;352;269;83
RONDONÓPOLIS;10;292;1791;316;244;72
RONDONÓPOLIS;10;293;1023;237;166;71
RONDONÓPOLIS;10;293;1023;236;165;71
RONDONÓPOLIS;10;294;1775;388;292;96
RONDONÓPOLIS;10;295;1805;371;276;95
RONDONÓPOLIS;10;296;1511;362;278;84
RONDONÓPOLIS;10;297;1813;390;265;125
RONDONÓPOLIS;10;298;1333;374;293;81
RONDONÓPOLIS;10;299;1759;379;288;91
RONDONÓPOLIS;10;300;1163;348;252;96
RONDONÓPOLIS;10;301;1775;383;269;114
RONDONÓPOLIS;10;302;1759;384;273;111
RONDONÓPOLIS;10;303;1155;347;257;90
RONDONÓPOLIS;10;304;1783;351;273;78
RONDONÓPOLIS;10;305;1333;376;311;65
RONDONÓPOLIS;10;307;1481;349;272;77
RONDONÓPOLIS;10;308;1775;387;283;104
RONDONÓPOLIS;10;309;1759;387;296;91
RONDONÓPOLIS;10;310;1163;351;232;119
RONDONÓPOLIS;10;311;1805;369;270;99
RONDONÓPOLIS;10;312;1759;378;253;125
RONDONÓPOLIS;10;314;1775;380;275;105
RONDONÓPOLIS;10;315;1155;346;263;83
RONDONÓPOLIS;10;316;1813;393;270;123
RONDONÓPOLIS;10;317;1023;247;175;72
RONDONÓPOLIS;10;318;1783;350;254;96
RONDONÓPOLIS;10;319;1333;369;296;73
RONDONÓPOLIS;10;321;1490;327;269;58
RONDONÓPOLIS;10;322;1538;387;281;106
RONDONÓPOLIS;10;323;1759;380;276;104
RONDONÓPOLIS;10;324;1813;390;274;116
RONDONÓPOLIS;10;325;1805;372;263;109
RONDONÓPOLIS;10;327;1775;381;272;109
RONDONÓPOLIS;10;328;1783;348;236;112
RONDONÓPOLIS;10;329;1759;388;270;118
RONDONÓPOLIS;10;330;1333;365;273;92
RONDONÓPOLIS;10;331;1481;349;244;105
RONDONÓPOLIS;10;332;1813;386;258;128
ITIQUIRA;10;333;1015;391;293;98
ITIQUIRA;10;334;1015;394;302;92
ITIQUIRA;10;335;1015;396;282;114
ITIQUIRA;10;336;1015;384;288;96
ITIQUIRA;10;336;1015;383;287;96
ITIQUIRA;10;337;1015;395;272;123
ITIQUIRA;10;338;1023;322;249;73
ITIQUIRA;10;339;1023;314;241;73
ITIQUIRA;10;340;1023;314;227;87
ITIQUIRA;10;341;1023;316;238;78
ITIQUIRA;10;342;1023;314;233;81
ITIQUIRA;10;343;1023;312;231;81
ITIQUIRA;10;344;1023;309;235;74
ITIQUIRA;10;345;1023;321;241;80
ITIQUIRA;10;346;1023;314;227;87
ITIQUIRA;10;347;1023;299;207;92
ITIQUIRA;10;348;1031;377;273;104
ITIQUIRA;10;349;1031;363;286;77
ITIQUIRA;10;350;1031;366;266;100
ITIQUIRA;10;351;1031;379;278;101
ITIQUIRA;10;352;1031;371;280;91
ITIQUIRA;10;353;1031;372;273;99
ITIQUIRA;10;354;1031;377;271;106
ITIQUIRA;10;355;1040;342;264;78
ITIQUIRA;10;356;1040;349;231;118
ITIQUIRA;10;357;1040;341;222;119
ITIQUIRA;10;358;1031;381;253;128
RONDONÓPOLIS;10;359;1759;376;235;141
RONDONÓPOLIS;10;360;1821;353;281;72
RONDONÓPOLIS;10;361;1821;348;278;70
RONDONÓPOLIS;10;362;1821;345;281;64
RONDONÓPOLIS;10;363;1821;351;278;73
RONDONÓPOLIS;10;364;1821;340;275;65
RONDONÓPOLIS;10;365;1821;350;286;64
RONDONÓPOLIS;10;366;1821;346;279;67
RONDONÓPOLIS;10;367;1821;344;282;62
RONDONÓPOLIS;10;368;1830;319;274;45
RONDONÓPOLIS;10;369;1830;307;253;54
RONDONÓPOLIS;10;370;1830;319;258;61
RONDONÓPOLIS;10;371;1830;302;252;50
RONDONÓPOLIS;10;372;1830;300;237;63
RONDONÓPOLIS;10;373;1856;319;260;59
RONDONÓPOLIS;10;374;1856;312;247;65
RONDONÓPOLIS;10;375;1856;315;270;45
RONDONÓPOLIS;10;376;1856;315;266;49
RONDONÓPOLIS;10;377;1856;309;276;33
RONDONÓPOLIS;10;378;1856;307;254;53
RONDONÓPOLIS;10;379;1856;309;239;70
RONDONÓPOLIS;10;380;1856;366;311;55
RONDONÓPOLIS;10;381;1856;365;304;61
RONDONÓPOLIS;10;382;1856;367;286;81
RONDONÓPOLIS;10;383;1856;362;252;110
RONDONÓPOLIS;10;384;1856;354;260;94
RONDONÓPOLIS;10;384;1856;353;260;93
RONDONÓPOLIS;10;385;1864;236;180;56
RONDONÓPOLIS;10;386;1864;232;187;45
RONDONÓPOLIS;10;387;1864;238;181;57
RONDONÓPOLIS;10;388;1864;233;166;67
RONDONÓPOLIS;10;389;1864;228;163;65
RONDONÓPOLIS;10;390;1864;231;174;57
RONDONÓPOLIS;10;391;1864;239;184;55
RONDONÓPOLIS;10;392;1864;235;173;62
RONDONÓPOLIS;10;393;1864;234;177;57
RONDONÓPOLIS;10;394;1864;232;177;55
RONDONÓPOLIS;10;395;1864;238;179;59
RONDONÓPOLIS;10;396;1864;232;184;48
RONDONÓPOLIS;10;397;1864;240;185;55
RONDONÓPOLIS;10;398;1864;240;177;63
RONDONÓPOLIS;10;399;1864;229;189;40
RONDONÓPOLIS;10;400;1864;235;182;53
RONDONÓPOLIS;10;401;1872;307;254;53
RONDONÓPOLIS;10;402;1872;301;257;44
RONDONÓPOLIS;10;403;1872;310;266;44
RONDONÓPOLIS;10;404;1872;303;243;60
RONDONÓPOLIS;10;406;1880;338;292;46
RONDONÓPOLIS;10;409;1899;384;300;84
RONDONÓPOLIS;10;410;1899;384;302;82
RONDONÓPOLIS;10;411;1899;371;306;65
RONDONÓPOLIS;10;412;1899;370;289;81
RONDONÓPOLIS;10;413;1899;378;313;65
RONDONÓPOLIS;10;414;1899;376;290;86
RONDONÓPOLIS;10;415;1899;370;259;111
RONDONÓPOLIS;10;416;1902;308;243;65
RONDONÓPOLIS;10;417;1902;300;235;65
RONDONÓPOLIS;10;418;1902;303;236;67
RONDONÓPOLIS;10;419;1902;305;242;63
RONDONÓPOLIS;10;420;1902;307;239;68
RONDONÓPOLIS;10;421;1902;305;238;67
RONDONÓPOLIS;10;422;1902;303;232;71
RONDONÓPOLIS;10;424;1902;304;232;72
RONDONÓPOLIS;10;425;1910;376;301;75
RONDONÓPOLIS;10;426;1910;372;293;79
RONDONÓPOLIS;10;427;1910;373;299;74
RONDONÓPOLIS;10;428;1910;373;299;74
RONDONÓPOLIS;10;429;1910;369;276;93
RONDONÓPOLIS;10;430;1929;398;311;87
RONDONÓPOLIS;10;431;1929;395;306;89
RONDONÓPOLIS;10;432;1929;396;289;107
RONDONÓPOLIS;10;433;1929;394;290;104
RONDONÓPOLIS;10;434;1929;391;290;101
RONDONÓPOLIS;10;435;1929;391;309;82
RONDONÓPOLIS;10;436;1929;394;302;92
RONDONÓPOLIS;10;437;1929;390;282;108
RONDONÓPOLIS;10;438;1929;392;290;102
RONDONÓPOLIS;10;439;1937;331;265;66
RONDONÓPOLIS;10;440;1937;324;263;61
RONDONÓPOLIS;10;441;1937;323;254;69
RONDONÓPOLIS;10;442;1937;320;266;54
RONDONÓPOLIS;10;443;1937;325;269;56
RONDONÓPOLIS;10;444;1937;325;260;65
RONDONÓPOLIS;10;445;1937;324;255;69
RONDONÓPOLIS;10;446;1937;324;255;69
RONDONÓPOLIS;10;447;1937;323;256;67
RONDONÓPOLIS;10;448;1937;318;254;64
RONDONÓPOLIS;10;449;1937;322;260;62
RONDONÓPOLIS;10;450;1937;320;254;66
RONDONÓPOLIS;10;451;1937;322;240;82
RONDONÓPOLIS;10;452;1945;381;298;83
RONDONÓPOLIS;10;452;1945;380;297;83
RONDONÓPOLIS;10;453;1945;378;286;92
RONDONÓPOLIS;10;454;1945;384;278;106
RONDONÓPOLIS;10;455;1945;385;284;101
RONDONÓPOLIS;10;456;1945;384;300;84
RONDONÓPOLIS;10;458;1805;369;257;112
RONDONÓPOLIS;10;459;1813;393;275;118
RONDONÓPOLIS;10;460;1929;392;284;108
RONDONÓPOLIS;10;461;1759;396;280;116
RONDONÓPOLIS;10;462;1333;372;323;49
RONDONÓPOLIS;10;463;1856;318;278;40
RONDONÓPOLIS;10;464;1899;361;293;68
RONDONÓPOLIS;10;465;1945;228;191;37
RONDONÓPOLIS;10;466;2011;213;180;33
RONDONÓPOLIS;10;467;2020;251;210;41
RONDONÓPOLIS;10;468;1775;109;86;23
RONDONÓPOLIS;10;469;1759;122;85;37
COLNIZA;11;36;1015;391;276;115
COLNIZA;11;37;1015;388;266;122
COLNIZA;11;38;1015;387;262;125
COLNIZA;11;39;1015;386;263;123
COLNIZA;11;40;1015;387;265;122
COLNIZA;11;41;1015;392;268;124
COLNIZA;11;42;1015;385;264;121
COLNIZA;11;43;1295;307;226;81
COLNIZA;11;44;1295;307;215;92
COLNIZA;11;45;1295;309;221;88
COLNIZA;11;46;1295;303;197;106
COLNIZA;11;47;1295;304;215;89
COLNIZA;11;48;1368;396;271;125
COLNIZA;11;48;1368;395;270;125
COLNIZA;11;49;1368;397;280;117
COLNIZA;11;50;1368;399;271;128
COLNIZA;11;56;1368;393;259;134
COLNIZA;11;57;1031;268;205;63
COLNIZA;11;58;1031;266;180;86
COLNIZA;11;59;1031;266;196;70
COLNIZA;11;60;1031;268;197;71
COLNIZA;11;61;1031;273;195;78
COLNIZA;11;62;1031;272;182;90
COLNIZA;11;63;1031;270;203;67
COLNIZA;11;64;1031;269;193;76
COLNIZA;11;65;1031;267;181;86
COLNIZA;11;66;1031;267;180;87
COLNIZA;11;67;1350;328;239;89
COLNIZA;11;68;1058;399;272;127
COLNIZA;11;69;1066;167;132;35
COLNIZA;11;70;1074;369;272;97
COLNIZA;11;71;1082;271;205;66
COLNIZA;11;72;1325;380;268;112
COLNIZA;11;73;1104;271;194;77
COLNIZA;11;75;1139;275;196;79
COLNIZA;11;76;1279;285;217;68
COLNIZA;11;77;1074;370;257;113
COLNIZA;11;78;1163;268;198;70
COLNIZA;11;79;1163;272;172;100
COLNIZA;11;80;1163;271;192;79
COLNIZA;11;81;1163;268;181;87
COLNIZA;11;82;1163;269;195;74
COLNIZA;11;83;1163;271;185;86
COLNIZA;11;84;1163;271;179;92
COLNIZA;11;85;1171;274;163;111
COLNIZA;11;86;1180;357;244;113
COLNIZA;11;87;1198;326;253;73
COLNIZA;11;88;1201;162;116;46
COLNIZA;11;89;1210;202;163;39
COLNIZA;11;90;1228;266;156;110
COLNIZA;11;90;1228;265;155;110
COLNIZA;11;91;1236;118;102;16
ARIPUANÃ;11;92;1023;393;250;143
ARIPUANÃ;11;94;1023;382;254;128
ARIPUANÃ;11;96;1023;391;265;126
ARIPUANÃ;11;98;1023;390;273;117
ARIPUANÃ;11;100;1023;388;244;144
ARIPUANÃ;11;102;1023;391;262;129
ARIPUANÃ;11;104;1023;386;259;127
ARIPUANÃ;11;106;1023;200;138;62
ARIPUANÃ;11;106;1023;199;138;61
ARIPUANÃ;11;107;1040;393;261;132
ARIPUANÃ;11;110;1074;224;142;82
ARIPUANÃ;11;111;1082;140;92;48
ARIPUANÃ;11;112;1112;385;218;167
ARIPUANÃ;11;113;1104;390;283;107
ARIPUANÃ;11;114;1104;392;283;109
ARIPUANÃ;11;115;1104;386;267;119
ARIPUANÃ;11;116;1104;389;276;113
ARIPUANÃ;11;117;1104;383;270;113
ARIPUANÃ;11;118;1112;385;258;127
ARIPUANÃ;11;119;1112;393;239;154
ARIPUANÃ;11;120;1112;387;253;134
ARIPUANÃ;11;121;1112;385;270;115
ARIPUANÃ;11;122;1112;391;255;136
ARIPUANÃ;11;123;1120;356;244;112
ARIPUANÃ;11;124;1120;353;218;135
ARIPUANÃ;11;125;1120;351;219;132
ARIPUANÃ;11;126;1120;352;221;131
ARIPUANÃ;11;126;1120;350;219;131
ARIPUANÃ;11;127;1120;354;240;114
ARIPUANÃ;11;129;1147;318;223;95
ARIPUANÃ;11;141;1112;391;245;146
ARIPUANÃ;11;141;1112;390;244;146
COLNIZA;11;142;1163;268;185;83
COLNIZA;11;144;1368;396;270;126
ARIPUANÃ;11;145;1155;346;225;121
ARIPUANÃ;11;146;1112;387;247;140
COLNIZA;11;147;1031;265;183;82
ARIPUANÃ;11;148;1104;387;282;105
COLNIZA;11;149;1279;283;213;70
COLNIZA;11;151;1260;177;124;53
COLNIZA;11;152;1333;195;161;34
COLNIZA;11;153;1252;119;91;28
ARIPUANÃ;11;154;1155;344;221;123
ARIPUANÃ;11;155;1163;60;35;25
COLNIZA;11;156;1139;275;197;78
COLNIZA;11;159;1015;387;247;140
ARIPUANÃ;11;160;1155;346;234;112
ARIPUANÃ;11;161;1104;388;261;127
ARIPUANÃ;11;162;1155;347;211;136
COLNIZA;11;163;1198;109;89;20
ARIPUANÃ;11;164;1120;358;271;87
ARIPUANÃ;11;165;1147;164;136;28
ARIPUANÃ;11;166;1155;350;249;101
ARIPUANÃ;11;170;1112;83;58;25
DOM AQUINO;12;1;1015;264;204;60
DOM AQUINO;12;2;1015;268;214;54
DOM AQUINO;12;3;1015;265;215;50
DOM AQUINO;12;4;1015;277;218;59
DOM AQUINO;12;5;1015;271;203;68
DOM AQUINO;12;6;1015;273;213;60
DOM AQUINO;12;9;1023;384;282;102
DOM AQUINO;12;11;1023;387;271;116
DOM AQUINO;12;12;1023;388;287;101
DOM AQUINO;12;13;1031;255;191;64
DOM AQUINO;12;14;1031;259;211;48
DOM AQUINO;12;15;1031;267;196;71
DOM AQUINO;12;16;1058;388;294;94
CAMPO VERDE;12;17;1015;393;314;79
CAMPO VERDE;12;18;1015;392;305;87
CAMPO VERDE;12;19;1015;392;301;91
CAMPO VERDE;12;20;1023;384;287;97
DOM AQUINO;12;21;1082;334;255;79
DOM AQUINO;12;23;1031;255;208;47
CAMPO VERDE;12;24;1015;393;317;76
CAMPO VERDE;12;25;1023;381;281;100
CAMPO VERDE;12;26;1023;381;271;110
CAMPO VERDE;12;27;1023;381;288;93
CAMPO VERDE;12;28;1015;389;309;80
DOM AQUINO;12;29;1031;255;199;56
CAMPO VERDE;12;30;1040;320;249;71
DOM AQUINO;12;31;1031;264;207;57
DOM AQUINO;12;33;1015;269;220;49
DOM AQUINO;12;34;1082;330;254;76
CAMPO VERDE;12;35;1015;394;306;88
CAMPO VERDE;12;36;1031;297;236;61
CAMPO VERDE;12;37;1015;388;311;77
CAMPO VERDE;12;38;1015;392;310;82
CAMPO VERDE;12;39;1015;387;300;87
DOM AQUINO;12;40;1082;336;254;82
CAMPO VERDE;12;41;1015;390;311;79
CAMPO VERDE;12;42;1023;379;265;114
CAMPO VERDE;12;43;1058;370;284;86
CAMPO VERDE;12;44;1058;370;307;63
CAMPO VERDE;12;45;1058;370;293;77
CAMPO VERDE;12;46;1066;379;316;63
CAMPO VERDE;12;47;1023;379;280;99
CAMPO VERDE;12;48;1058;369;299;70
CAMPO VERDE;12;49;1066;375;314;61
CAMPO VERDE;12;50;1058;363;286;77
CAMPO VERDE;12;51;1066;384;330;54
CAMPO VERDE;12;52;1058;368;304;64
CAMPO VERDE;12;53;1066;375;315;60
CAMPO VERDE;12;54;1023;378;272;106
CAMPO VERDE;12;55;1058;364;293;71
CAMPO VERDE;12;56;1066;378;306;72
CAMPO VERDE;12;57;1074;391;290;101
CAMPO VERDE;12;58;1066;377;324;53
CAMPO VERDE;12;59;1074;383;292;91
CAMPO VERDE;12;60;1074;391;290;101
CAMPO VERDE;12;61;1074;389;292;97
CAMPO VERDE;12;62;1023;373;259;114
CAMPO VERDE;12;63;1066;374;321;53
CAMPO VERDE;12;64;1082;276;184;92
CAMPO VERDE;12;65;1074;388;288;100
CAMPO VERDE;12;66;1066;375;314;61
CAMPO VERDE;12;67;1040;314;239;75
CAMPO VERDE;12;68;1023;373;281;92
CAMPO VERDE;12;69;1074;387;286;101
CAMPO VERDE;12;70;1074;386;294;92
CAMPO VERDE;12;71;1058;372;293;79
CAMPO VERDE;12;72;1066;382;310;72
CAMPO VERDE;12;73;1090;348;264;84
CAMPO VERDE;12;74;1074;389;283;106
CAMPO VERDE;12;75;1074;388;277;111
CAMPO VERDE;12;76;1066;377;299;78
CAMPO VERDE;12;77;1058;365;290;75
CAMPO VERDE;12;78;1074;383;272;111
CAMPO VERDE;12;79;1104;386;280;106
CAMPO VERDE;12;80;1112;380;288;92
CAMPO VERDE;12;81;1090;330;249;81
CAMPO VERDE;12;83;1104;385;278;107
CAMPO VERDE;12;84;1112;388;314;74
CAMPO VERDE;12;85;1120;326;236;90
CAMPO VERDE;12;86;1104;384;265;119
CAMPO VERDE;12;87;1112;390;297;93
CAMPO VERDE;12;88;1120;328;241;87
CAMPO VERDE;12;89;1120;327;249;78
CAMPO VERDE;12;90;1104;385;281;104
CAMPO VERDE;12;91;1120;323;242;81
CAMPO VERDE;12;92;1112;387;294;93
CAMPO VERDE;12;93;1120;327;251;76
CAMPO VERDE;12;94;1120;330;260;70
CAMPO VERDE;12;95;1104;391;300;91
CAMPO VERDE;12;96;1112;389;311;78
CAMPO VERDE;12;97;1090;328;243;85
DOM AQUINO;12;98;1082;345;254;91
CAMPO VERDE;12;99;1120;321;219;102
CAMPO VERDE;12;100;1112;384;296;88
CAMPO VERDE;12;101;1139;382;280;102
CAMPO VERDE;12;102;1104;387;263;124
CAMPO VERDE;12;103;1112;387;289;98
CAMPO VERDE;12;104;1139;380;256;124
CAMPO VERDE;12;105;1147;334;259;75
CAMPO VERDE;12;106;1139;388;261;127
CAMPO VERDE;12;107;1147;276;201;75
CAMPO VERDE;12;108;1139;386;242;144
CAMPO VERDE;12;109;1139;382;285;97
CAMPO VERDE;12;110;1120;328;246;82
CAMPO VERDE;12;112;1139;387;270;117
CAMPO VERDE;12;113;1090;174;132;42
CAMPO VERDE;12;114;1139;354;305;49
BARRA DO BUGRES;13;1;1023;399;280;119
BARRA DO BUGRES;13;2;1023;279;194;85
BARRA DO BUGRES;13;3;1023;272;200;72
BARRA DO BUGRES;13;4;1023;274;191;83
BARRA DO BUGRES;13;5;1023;266;211;55
BARRA DO BUGRES;13;6;1023;279;192;87
BARRA DO BUGRES;13;7;1562;298;223;75
BARRA DO BUGRES;13;8;1066;323;233;90
BARRA DO BUGRES;13;9;1066;314;238;76
BARRA DO BUGRES;13;10;1066;327;242;85
BARRA DO BUGRES;13;11;1066;314;241;73
BARRA DO BUGRES;13;12;1562;306;245;61
BARRA DO BUGRES;13;13;1066;307;241;66
BARRA DO BUGRES;13;14;1562;302;222;80
BARRA DO BUGRES;13;15;1023;298;200;98
BARRA DO BUGRES;13;16;1287;212;136;76
BARRA DO BUGRES;13;17;1287;213;147;66
BARRA DO BUGRES;13;18;1279;321;236;85
BARRA DO BUGRES;13;19;1279;309;236;73
BARRA DO BUGRES;13;20;1112;363;273;90
BARRA DO BUGRES;13;21;1112;363;271;92
BARRA DO BUGRES;13;22;1112;360;278;82
BARRA DO BUGRES;13;23;1112;365;254;111
BARRA DO BUGRES;13;24;1112;360;248;112
BARRA DO BUGRES;13;25;1023;295;192;103
BARRA DO BUGRES;13;27;1147;350;226;124
BARRA DO BUGRES;13;35;1171;333;248;85
BARRA DO BUGRES;13;36;1171;336;256;80
PORTO ESTRELA;13;37;1023;378;274;104
PORTO ESTRELA;13;38;1015;323;235;88
PORTO ESTRELA;13;39;1015;324;236;88
PORTO ESTRELA;13;40;1015;321;237;84
PORTO ESTRELA;13;41;1015;323;250;73
DENISE;13;43;1015;318;252;66
DENISE;13;44;1015;331;252;79
DENISE;13;47;1066;279;228;51
DENISE;13;48;1066;278;217;61
DENISE;13;49;1015;390;285;105
DENISE;13;50;1015;380;279;101
BARRA DO BUGRES;13;52;1279;305;232;73
BARRA DO BUGRES;13;53;1260;291;225;66
BARRA DO BUGRES;13;55;1287;208;153;55
PORTO ESTRELA;13;56;1015;322;262;60
DENISE;13;57;1015;317;257;60
DENISE;13;58;1015;309;255;54
BARRA DO BUGRES;13;62;1023;264;199;65
BARRA DO BUGRES;13;63;1023;398;291;107
PORTO ESTRELA;13;65;1023;377;307;70
BARRA DO BUGRES;13;66;1279;295;232;63
PORTO ESTRELA;13;71;1031;213;165;48
BARRA DO BUGRES;13;72;1260;288;230;58
BARRA DO BUGRES;13;75;1562;294;232;62
BARRA DO BUGRES;13;76;1457;385;275;110
BARRA DO BUGRES;13;78;1279;309;225;84
DENISE;13;79;1066;365;287;78
BARRA DO BUGRES;13;82;1279;303;231;72
BARRA DO BUGRES;13;83;1457;408;283;125
BARRA DO BUGRES;13;85;1457;381;294;87
BARRA DO BUGRES;13;91;1171;335;254;81
BARRA DO BUGRES;13;93;1260;287;215;72
BARRA DO BUGRES;13;94;1457;398;269;129
DENISE;13;95;1066;360;275;85
BARRA DO BUGRES;13;98;1023;268;204;64
BARRA DO BUGRES;13;100;1457;384;284;100
DENISE;13;101;1015;280;222;58
BARRA DO BUGRES;13;104;1066;312;245;67
BARRA DO BUGRES;13;107;1260;290;226;64
DENISE;13;108;1074;337;272;65
BARRA DO BUGRES;13;110;1112;346;262;84
BARRA DO BUGRES;13;112;1465;309;216;93
BARRA DO BUGRES;13;113;1465;304;222;82
BARRA DO BUGRES;13;114;1023;264;202;62
BARRA DO BUGRES;13;115;1279;302;232;70
BARRA DO BUGRES;13;115;1279;301;231;70
BARRA DO BUGRES;13;116;1481;382;294;88
BARRA DO BUGRES;13;117;1473;329;261;68
DENISE;13;120;1074;333;279;54
BARRA DO BUGRES;13;124;1481;387;291;96
BARRA DO BUGRES;13;125;1473;316;243;73
DENISE;13;127;1074;333;263;70
BARRA DO BUGRES;13;128;1260;300;209;91
BARRA DO BUGRES;13;129;1066;303;239;64
BARRA DO BUGRES;13;131;1481;370;289;81
BARRA DO BUGRES;13;132;1490;175;133;42
BARRA DO BUGRES;13;133;1511;406;296;110
BARRA DO BUGRES;13;134;1503;342;236;106
BARRA DO BUGRES;13;138;1520;284;230;54
BARRA DO BUGRES;13;140;1538;203;155;48
PORTO ESTRELA;13;142;1040;130;108;22
PORTO ESTRELA;13;144;1058;206;169;37
BARRA DO BUGRES;13;146;1457;380;287;93
BARRA DO BUGRES;13;147;1511;396;291;105
DENISE;13;148;1074;331;271;60
PORTO ESTRELA;13;150;1031;206;158;48
BARRA DO BUGRES;13;151;1112;358;271;87
BARRA DO BUGRES;13;155;1473;346;261;85
BARRA DO BUGRES;13;157;1112;355;242;113
BARRA DO BUGRES;13;158;1481;370;295;75
BARRA DO BUGRES;13;159;1457;388;302;86
BARRA DO BUGRES;13;160;1511;397;304;93
BARRA DO BUGRES;13;161;1511;378;296;82
BARRA DO BUGRES;13;162;1473;232;175;57
DENISE;13;163;1074;350;313;37
DENISE;13;164;1015;338;305;33
JACIARA;14;1;1015;358;288;70
JACIARA;14;2;1015;355;282;73
JACIARA;14;3;1015;357;286;71
JACIARA;14;4;1015;356;293;63
JACIARA;14;5;1040;324;277;47
JACIARA;14;6;1040;320;260;60
JACIARA;14;7;1040;319;255;64
JACIARA;14;8;1040;327;268;59
JACIARA;14;9;1031;319;263;56
JACIARA;14;10;1031;320;243;77
JACIARA;14;11;1031;317;254;63
JACIARA;14;12;1031;336;272;64
JACIARA;14;13;1040;373;288;85
JACIARA;14;14;1040;371;283;88
JACIARA;14;15;1040;372;301;71
JACIARA;14;16;1040;365;298;67
JACIARA;14;17;1031;323;254;69
JACIARA;14;18;1031;322;269;53
JACIARA;14;19;1031;323;255;68
JACIARA;14;20;1139;312;238;74
JACIARA;14;21;1139;307;249;58
JACIARA;14;22;1139;308;231;77
JACIARA;14;23;1139;309;242;67
JACIARA;14;24;1139;309;250;59
JACIARA;14;25;1139;304;224;80
JACIARA;14;26;1139;310;238;72
JACIARA;14;27;1082;338;269;69
JACIARA;14;28;1082;344;265;79
JACIARA;14;29;1082;341;251;90
JACIARA;14;30;1090;410;309;101
JACIARA;14;30;1090;409;308;101
SÃO PEDRO DA CIPA;14;31;1015;377;266;111
SÃO PEDRO DA CIPA;14;32;1015;377;270;107
SÃO PEDRO DA CIPA;14;33;1015;372;292;80
SÃO PEDRO DA CIPA;14;34;1015;370;281;89
SÃO PEDRO DA CIPA;14;35;1015;369;273;96
JUSCIMEIRA;14;36;1015;304;226;78
JUSCIMEIRA;14;37;1015;306;236;70
JUSCIMEIRA;14;38;1015;315;237;78
JUSCIMEIRA;14;39;1023;345;264;81
JUSCIMEIRA;14;40;1023;352;258;94
JUSCIMEIRA;14;41;1023;344;270;74
JUSCIMEIRA;14;42;1023;367;275;92
JUSCIMEIRA;14;43;1031;266;194;72
JUSCIMEIRA;14;44;1031;262;197;65
JUSCIMEIRA;14;45;1023;350;256;94
JUSCIMEIRA;14;46;1031;273;203;70
JUSCIMEIRA;14;47;1031;274;206;68
JUSCIMEIRA;14;48;1058;243;173;70
JUSCIMEIRA;14;49;1058;220;181;39
JUSCIMEIRA;14;50;1074;221;157;64
JUSCIMEIRA;14;51;1074;219;156;63
JUSCIMEIRA;14;52;1082;245;175;70
JUSCIMEIRA;14;53;1082;238;174;64
JUSCIMEIRA;14;55;1112;427;304;123
JUSCIMEIRA;14;56;1112;410;286;124
JUSCIMEIRA;14;57;1082;247;183;64
JUSCIMEIRA;14;58;1082;234;166;68
JUSCIMEIRA;14;59;1082;253;174;79
JUSCIMEIRA;14;60;1031;265;209;56
JUSCIMEIRA;14;61;1074;222;153;69
JUSCIMEIRA;14;62;1015;297;221;76
JUSCIMEIRA;14;63;1031;257;208;49
JUSCIMEIRA;14;64;1082;233;190;43
JACIARA;14;65;1015;348;295;53
JACIARA;14;66;1031;315;257;58
JACIARA;14;67;1139;310;229;81
JACIARA;14;69;1082;345;287;58
SÃO PEDRO DA CIPA;14;70;1015;370;273;97
JACIARA;14;71;1139;311;254;57
SÃO PEDRO DA CIPA;14;72;1015;377;301;76
JACIARA;14;73;1040;313;250;63
JACIARA;14;74;1040;369;298;71
JACIARA;14;75;1104;383;296;87
JACIARA;14;76;1082;341;275;66
SÃO PEDRO DA CIPA;14;77;1015;374;302;72
JACIARA;14;78;1104;388;303;85
JUSCIMEIRA;14;79;1015;306;238;68
JUSCIMEIRA;14;80;1023;338;260;78
JACIARA;14;81;1104;377;285;92
JACIARA;14;82;1082;336;262;74
JACIARA;14;83;1031;316;251;65
JACIARA;14;84;1104;381;292;89
JACIARA;14;85;1104;377;279;98
JACIARA;14;86;1040;364;277;87
SÃO PEDRO DA CIPA;14;87;1015;368;271;97
JACIARA;14;88;1139;305;231;74
JACIARA;14;89;1031;319;240;79
JACIARA;14;90;1104;386;281;105
JACIARA;14;91;1139;302;225;77
JACIARA;14;92;1082;339;262;77
JACIARA;14;93;1139;300;225;75
JACIARA;14;94;1031;318;249;69
JACIARA;14;95;1104;379;284;95
JUSCIMEIRA;14;96;1015;297;230;67
JACIARA;14;97;1031;328;242;86
JACIARA;14;98;1104;388;279;109
JACIARA;14;99;1139;301;211;90
JACIARA;14;100;1015;352;251;101
JACIARA;14;102;1139;310;202;108
JUSCIMEIRA;14;103;1015;337;265;72
SÃO PEDRO DA CIPA;14;104;1015;266;237;29
JACIARA;14;105;1104;152;131;21
LUCIARA;15;1;1015;275;213;62
LUCIARA;15;2;1015;267;214;53
LUCIARA;15;3;1015;269;219;50
LUCIARA;15;4;1023;281;215;66
LUCIARA;15;5;1023;277;199;78
LUCIARA;15;6;1023;281;202;79
SÃO FÉLIX DO ARAGUAIA;15;30;1015;235;161;74
SÃO FÉLIX DO ARAGUAIA;15;31;1015;232;154;78
SÃO FÉLIX DO ARAGUAIA;15;32;1015;226;149;77
SÃO FÉLIX DO ARAGUAIA;15;33;1015;232;149;83
SÃO FÉLIX DO ARAGUAIA;15;34;1015;231;158;73
SÃO FÉLIX DO ARAGUAIA;15;35;1015;229;144;85
SÃO FÉLIX DO ARAGUAIA;15;36;1015;229;153;76
SÃO FÉLIX DO ARAGUAIA;15;37;1015;229;150;79
SÃO FÉLIX DO ARAGUAIA;15;38;1023;204;139;65
SÃO FÉLIX DO ARAGUAIA;15;39;1023;205;146;59
SÃO FÉLIX DO ARAGUAIA;15;39;1023;203;144;59
SÃO FÉLIX DO ARAGUAIA;15;40;1031;348;220;128
SÃO FÉLIX DO ARAGUAIA;15;41;1031;359;235;124
SÃO FÉLIX DO ARAGUAIA;15;42;1031;352;227;125
SÃO FÉLIX DO ARAGUAIA;15;43;1040;190;139;51
ALTO BOA VISTA;15;44;1082;277;186;91
ALTO BOA VISTA;15;45;1082;273;169;104
ALTO BOA VISTA;15;46;1082;273;176;97
ALTO BOA VISTA;15;47;1023;223;155;68
ALTO BOA VISTA;15;48;1023;213;170;43
SÃO FÉLIX DO ARAGUAIA;15;52;1090;229;130;99
SÃO FÉLIX DO ARAGUAIA;15;53;1090;228;154;74
SÃO FÉLIX DO ARAGUAIA;15;54;1104;308;175;133
SÃO FÉLIX DO ARAGUAIA;15;54;1104;307;174;133
NOVO SANTO ANTÔNIO;15;55;1015;331;219;112
NOVO SANTO ANTÔNIO;15;56;1015;324;217;107
SÃO FÉLIX DO ARAGUAIA;15;131;1015;228;172;56
ALTO BOA VISTA;15;134;1082;278;172;106
LUCIARA;15;157;1015;270;228;42
SÃO FÉLIX DO ARAGUAIA;15;167;1031;360;245;115
ALTO BOA VISTA;15;177;1023;235;154;81
ALTO BOA VISTA;15;179;1023;218;164;54
NOVO SANTO ANTÔNIO;15;200;1015;328;241;87
ALTO BOA VISTA;15;209;1023;233;158;75
SÃO FÉLIX DO ARAGUAIA;15;212;1104;309;203;106
NOVO SANTO ANTÔNIO;15;222;1015;330;247;83
ALTO BOA VISTA;15;224;1082;270;179;91
SÃO FÉLIX DO ARAGUAIA;15;228;1031;355;228;127
SÃO FÉLIX DO ARAGUAIA;15;230;1104;308;207;101
ALTO BOA VISTA;15;235;1023;208;146;62
ALTO BOA VISTA;15;235;1023;207;145;62
SÃO FÉLIX DO ARAGUAIA;15;236;1112;424;289;135
NOVO SANTO ANTÔNIO;15;237;1023;210;149;61
ALTO BOA VISTA;15;238;1023;208;150;58
LUCIARA;15;240;1015;267;182;85
SÃO FÉLIX DO ARAGUAIA;15;241;1023;207;157;50
NOVO SANTO ANTÔNIO;15;242;1015;329;217;112
SÃO FÉLIX DO ARAGUAIA;15;243;1104;311;209;102
SÃO FÉLIX DO ARAGUAIA;15;243;1104;310;208;102
SÃO FÉLIX DO ARAGUAIA;15;244;1147;144;120;24
SÃO FÉLIX DO ARAGUAIA;15;245;1031;352;283;69
ALTO BOA VISTA;15;246;1104;351;279;72
SÃO FÉLIX DO ARAGUAIA;15;248;1163;76;69;7
SÃO FÉLIX DO ARAGUAIA;15;248;1163;75;68;7
ALTO BOA VISTA;15;249;1090;155;134;21
ALTO BOA VISTA;15;250;1104;365;282;83
ALTO BOA VISTA;15;251;1104;354;260;94
SÃO FÉLIX DO ARAGUAIA;15;252;1104;313;218;95
SÃO FÉLIX DO ARAGUAIA;15;252;1104;312;217;95
VILA RICA;16;34;1015;346;245;101
VILA RICA;16;34;1015;345;244;101
VILA RICA;16;35;1015;351;250;101
VILA RICA;16;36;1015;348;236;112
VILA RICA;16;37;1015;360;251;109
VILA RICA;16;38;1015;345;224;121
VILA RICA;16;39;1015;359;252;107
VILA RICA;16;40;1015;349;240;109
VILA RICA;16;41;1015;355;241;114
VILA RICA;16;42;1015;355;246;109
VILA RICA;16;43;1015;357;246;111
VILA RICA;16;43;1015;355;245;110
VILA RICA;16;44;1015;354;235;119
VILA RICA;16;45;1015;348;243;105
VILA RICA;16;46;1015;356;228;128
VILA RICA;16;47;1015;354;245;109
VILA RICA;16;48;1015;367;239;128
VILA RICA;16;49;1015;352;234;118
VILA RICA;16;50;1104;313;201;112
VILA RICA;16;51;1104;308;198;110
VILA RICA;16;52;1082;262;192;70
VILA RICA;16;53;1031;174;133;41
VILA RICA;16;54;1040;300;213;87
VILA RICA;16;54;1040;299;213;86
VILA RICA;16;55;1040;312;218;94
VILA RICA;16;56;1040;300;223;77
VILA RICA;16;57;1040;295;223;72
VILA RICA;16;57;1040;294;222;72
VILA RICA;16;58;1040;295;220;75
VILA RICA;16;59;1040;306;232;74
VILA RICA;16;60;1040;301;224;77
VILA RICA;16;61;1040;306;224;82
VILA RICA;16;61;1040;304;223;81
VILA RICA;16;64;1074;240;173;67
VILA RICA;16;65;1074;242;178;64
VILA RICA;16;66;1074;253;179;74
VILA RICA;16;67;1074;249;167;82
VILA RICA;16;68;1074;262;176;86
SANTA TEREZINHA;16;69;1015;214;144;70
SANTA TEREZINHA;16;70;1015;212;153;59
SANTA TEREZINHA;16;71;1015;211;143;68
SANTA TEREZINHA;16;72;1015;212;141;71
SANTA TEREZINHA;16;73;1015;208;153;55
SANTA TEREZINHA;16;74;1015;213;126;87
SANTA TEREZINHA;16;75;1015;211;151;60
SANTA TEREZINHA;16;76;1023;227;156;71
SANTA TEREZINHA;16;77;1023;228;148;80
SANTA TEREZINHA;16;78;1023;227;143;84
SANTA TEREZINHA;16;79;1023;225;156;69
SANTA TEREZINHA;16;80;1023;229;164;65
SANTA TEREZINHA;16;81;1023;229;171;58
SANTA TEREZINHA;16;82;1023;229;162;67
SANTA TEREZINHA;16;83;1023;228;168;60
SANTA TEREZINHA;16;84;1040;131;89;42
SANTA TEREZINHA;16;85;1058;310;219;91
SANTA TEREZINHA;16;85;1058;309;218;91
SANTA TEREZINHA;16;86;1082;291;253;38
SANTA TEREZINHA;16;87;1074;249;181;68
SANTA CRUZ DO XINGU;16;101;1015;335;249;86
SANTA CRUZ DO XINGU;16;102;1015;333;232;101
SANTA CRUZ DO XINGU;16;103;1015;333;227;106
SANTA CRUZ DO XINGU;16;104;1015;328;218;110
SANTA CRUZ DO XINGU;16;105;1023;211;146;65
VILA RICA;16;106;1074;249;162;87
VILA RICA;16;107;1074;254;169;85
VILA RICA;16;108;1074;250;167;83
VILA RICA;16;109;1074;247;174;73
VILA RICA;16;110;1074;249;173;76
SANTA TEREZINHA;16;111;1074;252;173;79
VILA RICA;16;112;1090;295;199;96
SANTA TEREZINHA;16;113;1112;317;249;68
VILA RICA;16;114;1090;302;204;98
VILA RICA;16;115;1090;292;184;108
VILA RICA;16;117;1090;297;183;114
VILA RICA;16;118;1090;312;207;105
VILA RICA;16;118;1090;311;207;104
SANTA TEREZINHA;16;119;1058;104;70;34
VILA RICA;16;120;1090;293;172;121
VILA RICA;16;121;1040;296;206;90
VILA RICA;16;122;1104;290;206;84
VILA RICA;16;123;1090;298;198;100
SANTA CRUZ DO XINGU;16;124;1015;332;248;84
ARENÁPOLIS;17;1;1023;316;222;94
ARENÁPOLIS;17;3;1023;317;233;84
ARENÁPOLIS;17;8;1023;317;231;86
ARENÁPOLIS;17;10;1058;321;247;74
ARENÁPOLIS;17;11;1058;315;239;76
ARENÁPOLIS;17;12;1058;301;236;65
ARENÁPOLIS;17;13;1058;293;241;52
ARENÁPOLIS;17;14;1066;247;178;69
ARENÁPOLIS;17;15;1066;229;185;44
ARENÁPOLIS;17;16;1066;244;178;66
ARENÁPOLIS;17;17;1066;240;178;62
ARENÁPOLIS;17;18;1074;302;237;65
ARENÁPOLIS;17;19;1074;299;236;63
ARENÁPOLIS;17;20;1066;246;171;75
ARENÁPOLIS;17;21;1066;242;183;59
ARENÁPOLIS;17;22;1163;253;200;53
ARENÁPOLIS;17;23;1058;302;235;67
ARENÁPOLIS;17;24;1163;256;198;58
ARENÁPOLIS;17;25;1163;258;197;61
ARENÁPOLIS;17;26;1147;345;256;89
NOVA MARILÂNDIA;17;27;1015;318;243;75
NOVA MARILÂNDIA;17;28;1015;313;237;76
NOVA MARILÂNDIA;17;29;1015;314;241;73
SANTO AFONSO;17;31;1015;386;308;78
SANTO AFONSO;17;33;1015;382;288;94
SANTO AFONSO;17;34;1015;380;304;76
ARENÁPOLIS;17;35;1147;326;248;78
ARENÁPOLIS;17;36;1147;330;242;88
ARENÁPOLIS;17;37;1074;295;225;70
NOVA MARILÂNDIA;17;38;1015;313;247;66
ARENÁPOLIS;17;39;1163;254;192;62
ARENÁPOLIS;17;41;1147;334;253;81
ARENÁPOLIS;17;42;1058;302;253;49
NOVA MARILÂNDIA;17;43;1015;306;227;79
SANTO AFONSO;17;45;1015;384;284;100
SANTO AFONSO;17;46;1023;346;261;85
NOVA MARILÂNDIA;17;47;1015;311;237;74
NORTELÂNDIA;17;48;1015;229;178;51
NORTELÂNDIA;17;49;1015;230;175;55
NORTELÂNDIA;17;50;1015;229;183;46
NORTELÂNDIA;17;51;1015;230;171;59
NORTELÂNDIA;17;52;1015;234;185;49
NORTELÂNDIA;17;53;1015;232;182;50
NORTELÂNDIA;17;54;1015;232;185;47
NORTELÂNDIA;17;55;1015;227;191;36
NORTELÂNDIA;17;64;1031;182;141;41
NORTELÂNDIA;17;65;1031;182;149;33
NORTELÂNDIA;17;66;1031;179;142;37
NORTELÂNDIA;17;67;1031;182;138;44
NORTELÂNDIA;17;68;1031;178;148;30
NORTELÂNDIA;17;69;1031;182;145;37
NORTELÂNDIA;17;70;1031;182;149;33
NORTELÂNDIA;17;71;1040;302;235;67
NORTELÂNDIA;17;75;1040;296;244;52
NORTELÂNDIA;17;76;1040;302;227;75
NORTELÂNDIA;17;78;1040;301;230;71
NORTELÂNDIA;17;79;1015;230;182;48
NORTELÂNDIA;17;80;1015;233;182;51
NOVA MARILÂNDIA;17;83;1015;311;233;78
SANTO AFONSO;17;84;1031;244;187;57
NOVA MARILÂNDIA;17;85;1040;247;177;70
SANTO AFONSO;17;86;1040;156;111;45
NOVA MARILÂNDIA;17;89;1040;255;204;51
ARENÁPOLIS;17;90;1147;290;217;73
ARENÁPOLIS;17;91;1058;268;211;57
ARENÁPOLIS;17;91;1058;267;210;57
MIRASSOL D'OESTE;18;74;1015;184;131;53
MIRASSOL D'OESTE;18;75;1015;355;243;112
MIRASSOL D'OESTE;18;76;1023;287;205;82
MIRASSOL D'OESTE;18;77;1023;283;196;87
MIRASSOL D'OESTE;18;78;1023;287;188;99
MIRASSOL D'OESTE;18;79;1023;294;195;99
MIRASSOL D'OESTE;18;80;1023;299;196;103
MIRASSOL D'OESTE;18;81;1210;370;261;109
MIRASSOL D'OESTE;18;82;1210;380;256;124
MIRASSOL D'OESTE;18;83;1031;304;227;77
MIRASSOL D'OESTE;18;84;1031;301;228;73
MIRASSOL D'OESTE;18;85;1031;292;222;70
MIRASSOL D'OESTE;18;86;1031;306;229;77
MIRASSOL D'OESTE;18;87;1031;302;217;85
MIRASSOL D'OESTE;18;88;1031;306;222;84
MIRASSOL D'OESTE;18;89;1015;355;259;96
MIRASSOL D'OESTE;18;90;1015;352;249;103
MIRASSOL D'OESTE;18;92;1015;356;248;108
MIRASSOL D'OESTE;18;95;1015;355;267;88
MIRASSOL D'OESTE;18;97;1287;342;267;75
MIRASSOL D'OESTE;18;98;1287;346;254;92
MIRASSOL D'OESTE;18;99;1287;346;253;93
GLÓRIA D'OESTE;18;102;1015;284;211;73
GLÓRIA D'OESTE;18;103;1015;297;228;69
GLÓRIA D'OESTE;18;104;1015;291;230;61
GLÓRIA D'OESTE;18;105;1023;326;251;75
MIRASSOL D'OESTE;18;106;1120;296;210;86
MIRASSOL D'OESTE;18;107;1120;292;219;73
MIRASSOL D'OESTE;18;108;1120;284;210;74
MIRASSOL D'OESTE;18;110;1015;347;251;96
MIRASSOL D'OESTE;18;112;1015;355;242;113
MIRASSOL D'OESTE;18;113;1031;304;235;69
MIRASSOL D'OESTE;18;114;1031;295;230;65
MIRASSOL D'OESTE;18;116;1031;293;207;86
MIRASSOL D'OESTE;18;117;1031;314;241;73
MIRASSOL D'OESTE;18;118;1031;296;229;67
MIRASSOL D'OESTE;18;119;1031;293;233;60
MIRASSOL D'OESTE;18;119;1031;292;232;60
GLÓRIA D'OESTE;18;120;1015;283;224;59
MIRASSOL D'OESTE;18;132;1210;352;267;85
GLÓRIA D'OESTE;18;133;1015;300;224;76
GLÓRIA D'OESTE;18;135;1015;290;230;60
MIRASSOL D'OESTE;18;139;1210;346;258;88
MIRASSOL D'OESTE;18;140;1031;296;242;54
MIRASSOL D'OESTE;18;141;1015;354;275;79
MIRASSOL D'OESTE;18;143;1287;335;267;68
MIRASSOL D'OESTE;18;145;1287;332;259;73
MIRASSOL D'OESTE;18;146;1287;340;264;76
GLÓRIA D'OESTE;18;148;1015;287;221;66
MIRASSOL D'OESTE;18;149;1023;271;211;60
MIRASSOL D'OESTE;18;151;1023;277;197;80
PORTO ESPERIDIÃO;18;153;1015;181;134;47
PORTO ESPERIDIÃO;18;154;1015;355;263;92
PORTO ESPERIDIÃO;18;156;1023;367;241;126
PORTO ESPERIDIÃO;18;157;1023;367;264;103
PORTO ESPERIDIÃO;18;158;1023;371;261;110
PORTO ESPERIDIÃO;18;159;1023;367;270;97
PORTO ESPERIDIÃO;18;160;1023;371;247;124
PORTO ESPERIDIÃO;18;161;1023;370;272;98
PORTO ESPERIDIÃO;18;162;1023;371;279;92
PORTO ESPERIDIÃO;18;163;1023;371;299;72
PORTO ESPERIDIÃO;18;164;1023;364;273;91
PORTO ESPERIDIÃO;18;165;1031;182;126;56
PORTO ESPERIDIÃO;18;166;1023;363;263;100
PORTO ESPERIDIÃO;18;167;1058;227;168;59
PORTO ESPERIDIÃO;18;168;1058;231;169;62
PORTO ESPERIDIÃO;18;169;1066;285;211;74
PORTO ESPERIDIÃO;18;170;1066;282;196;86
PORTO ESPERIDIÃO;18;171;1074;291;209;82
PORTO ESPERIDIÃO;18;172;1074;294;226;68
MIRASSOL D'OESTE;18;173;1040;390;289;101
MIRASSOL D'OESTE;18;174;1023;279;215;64
MIRASSOL D'OESTE;18;175;1287;345;258;87
MIRASSOL D'OESTE;18;176;1325;279;195;84
MIRASSOL D'OESTE;18;177;1325;292;197;95
MIRASSOL D'OESTE;18;178;1023;277;214;63
MIRASSOL D'OESTE;18;179;1023;270;216;54
MIRASSOL D'OESTE;18;180;1210;354;265;89
MIRASSOL D'OESTE;18;181;1287;347;272;75
PORTO ESPERIDIÃO;18;182;1023;372;263;109
GLÓRIA D'OESTE;18;183;1015;294;226;68
MIRASSOL D'OESTE;18;184;1287;331;263;68
PORTO ESPERIDIÃO;18;185;1066;280;198;82
MIRASSOL D'OESTE;18;186;1040;386;290;96
MIRASSOL D'OESTE;18;187;1023;272;210;62
MIRASSOL D'OESTE;18;188;1309;245;202;43
MIRASSOL D'OESTE;18;189;1333;220;168;52
PORTO ESPERIDIÃO;18;190;1074;288;220;68
MIRASSOL D'OESTE;18;252;1325;297;209;88
MIRASSOL D'OESTE;18;253;1333;235;192;43
PORTO ESPERIDIÃO;18;254;1066;278;199;79
CURVELÂNDIA;18;255;1015;330;258;72
CURVELÂNDIA;18;256;1015;331;251;80
CURVELÂNDIA;18;257;1015;336;254;82
CURVELÂNDIA;18;258;1015;328;260;68
CURVELÂNDIA;18;259;1015;334;258;76
CURVELÂNDIA;18;260;1015;326;257;69
CURVELÂNDIA;18;261;1015;340;256;84
CURVELÂNDIA;18;262;1074;222;181;41
CURVELÂNDIA;18;263;1074;220;174;46
CURVELÂNDIA;18;264;1074;226;187;39
CURVELÂNDIA;18;265;1074;214;176;38
CURVELÂNDIA;18;266;1074;228;184;44
CURVELÂNDIA;18;267;1074;220;174;46
CURVELÂNDIA;18;268;1074;228;179;49
CURVELÂNDIA;18;269;1074;229;178;51
CURVELÂNDIA;18;270;1074;224;169;55
MIRASSOL D'OESTE;18;271;1325;287;192;95
MIRASSOL D'OESTE;18;272;1040;385;288;97
MIRASSOL D'OESTE;18;273;1333;228;181;47
PORTO ESPERIDIÃO;18;274;1082;117;87;30
MIRASSOL D'OESTE;18;275;1325;280;208;72
MIRASSOL D'OESTE;18;277;1210;341;259;82
PORTO ESPERIDIÃO;18;278;1023;371;261;110
MIRASSOL D'OESTE;18;279;1309;211;164;47
TANGARÁ DA SERRA;19;1;1015;380;273;107
TANGARÁ DA SERRA;19;2;1015;361;261;100
TANGARÁ DA SERRA;19;3;1147;321;231;90
TANGARÁ DA SERRA;19;4;1147;317;233;84
TANGARÁ DA SERRA;19;5;1031;318;223;95
TANGARÁ DA SERRA;19;6;1031;305;239;66
TANGARÁ DA SERRA;19;7;1031;310;229;81
TANGARÁ DA SERRA;19;8;1031;307;216;91
TANGARÁ DA SERRA;19;9;1031;318;238;80
TANGARÁ DA SERRA;19;10;1031;330;241;89
TANGARÁ DA SERRA;19;11;1031;311;239;72
TANGARÁ DA SERRA;19;12;1040;416;282;134
TANGARÁ DA SERRA;19;13;1040;411;273;138
TANGARÁ DA SERRA;19;14;1058;390;269;121
TANGARÁ DA SERRA;19;15;1058;400;272;128
TANGARÁ DA SERRA;19;16;1465;291;222;69
TANGARÁ DA SERRA;19;17;1465;296;220;76
TANGARÁ DA SERRA;19;18;1465;291;211;80
TANGARÁ DA SERRA;19;19;1465;283;207;76
TANGARÁ DA SERRA;19;20;1147;319;232;87
TANGARÁ DA SERRA;19;21;1147;328;226;102
TANGARÁ DA SERRA;19;22;1147;317;225;92
TANGARÁ DA SERRA;19;23;1147;312;229;83
TANGARÁ DA SERRA;19;24;1147;329;236;93
TANGARÁ DA SERRA;19;25;1104;270;193;77
TANGARÁ DA SERRA;19;26;1104;274;190;84
TANGARÁ DA SERRA;19;27;1104;285;195;90
TANGARÁ DA SERRA;19;28;1104;284;199;85
TANGARÁ DA SERRA;19;29;1104;279;210;69
TANGARÁ DA SERRA;19;30;1104;276;192;84
TANGARÁ DA SERRA;19;31;1104;272;195;77
TANGARÁ DA SERRA;19;32;1104;279;198;81
TANGARÁ DA SERRA;19;33;1120;431;304;127
TANGARÁ DA SERRA;19;34;1139;336;226;110
TANGARÁ DA SERRA;19;35;1139;333;241;92
TANGARÁ DA SERRA;19;36;1139;334;243;91
TANGARÁ DA SERRA;19;37;1139;327;244;83
TANGARÁ DA SERRA;19;38;1139;333;241;92
TANGARÁ DA SERRA;19;39;1139;338;236;102
TANGARÁ DA SERRA;19;40;1147;308;239;69
TANGARÁ DA SERRA;19;41;1155;353;251;102
TANGARÁ DA SERRA;19;42;1155;364;266;98
TANGARÁ DA SERRA;19;43;1163;303;228;75
TANGARÁ DA SERRA;19;44;1163;301;223;78
TANGARÁ DA SERRA;19;45;1163;293;227;66
TANGARÁ DA SERRA;19;46;1163;277;210;67
TANGARÁ DA SERRA;19;47;1163;284;209;75
TANGARÁ DA SERRA;19;48;1163;294;221;73
TANGARÁ DA SERRA;19;49;1171;333;223;110
TANGARÁ DA SERRA;19;50;1171;343;235;108
TANGARÁ DA SERRA;19;51;1015;360;268;92
TANGARÁ DA SERRA;19;53;1201;151;106;45
TANGARÁ DA SERRA;19;54;1201;279;204;75
TANGARÁ DA SERRA;19;55;1210;312;233;79
TANGARÁ DA SERRA;19;56;1210;307;224;83
TANGARÁ DA SERRA;19;57;1210;315;222;93
TANGARÁ DA SERRA;19;58;1120;408;271;137
TANGARÁ DA SERRA;19;59;1120;426;278;148
TANGARÁ DA SERRA;19;61;1244;197;128;69
TANGARÁ DA SERRA;19;62;1244;362;248;114
TANGARÁ DA SERRA;19;63;1252;332;232;100
TANGARÁ DA SERRA;19;66;1465;297;208;89
TANGARÁ DA SERRA;19;67;1465;280;197;83
TANGARÁ DA SERRA;19;68;1147;300;237;63
TANGARÁ DA SERRA;19;69;1031;328;256;72
TANGARÁ DA SERRA;19;70;1031;311;242;69
TANGARÁ DA SERRA;19;71;1147;314;235;79
TANGARÁ DA SERRA;19;72;1147;308;228;80
TANGARÁ DA SERRA;19;73;1139;325;267;58
TANGARÁ DA SERRA;19;74;1163;292;226;66
TANGARÁ DA SERRA;19;75;1155;346;257;89
TANGARÁ DA SERRA;19;76;1155;344;258;86
TANGARÁ DA SERRA;19;77;1155;361;275;86
TANGARÁ DA SERRA;19;78;1031;312;233;79
TANGARÁ DA SERRA;19;79;1058;389;278;111
TANGARÁ DA SERRA;19;80;1147;306;226;80
TANGARÁ DA SERRA;19;81;1147;308;238;70
TANGARÁ DA SERRA;19;82;1104;269;201;68
TANGARÁ DA SERRA;19;83;1139;328;255;73
TANGARÁ DA SERRA;19;84;1171;323;239;84
TANGARÁ DA SERRA;19;101;1147;299;231;68
TANGARÁ DA SERRA;19;101;1147;298;230;68
TANGARÁ DA SERRA;19;102;1040;405;292;113
TANGARÁ DA SERRA;19;103;1058;392;285;107
TANGARÁ DA SERRA;19;104;1120;389;289;100
TANGARÁ DA SERRA;19;105;1155;356;260;96
TANGARÁ DA SERRA;19;106;1163;288;234;54
TANGARÁ DA SERRA;19;110;1031;304;226;78
TANGARÁ DA SERRA;19;111;1171;335;232;103
TANGARÁ DA SERRA;19;112;1465;277;206;71
TANGARÁ DA SERRA;19;113;1279;326;225;101
TANGARÁ DA SERRA;19;115;1139;323;249;74
TANGARÁ DA SERRA;19;116;1031;307;242;65
TANGARÁ DA SERRA;19;119;1287;378;265;113
TANGARÁ DA SERRA;19;122;1163;284;233;51
TANGARÁ DA SERRA;19;123;1171;331;235;96
TANGARÁ DA SERRA;19;124;1015;357;265;92
TANGARÁ DA SERRA;19;125;1031;310;233;77
TANGARÁ DA SERRA;19;127;1465;280;212;68
TANGARÁ DA SERRA;19;128;1058;382;278;104
TANGARÁ DA SERRA;19;129;1120;405;299;106
TANGARÁ DA SERRA;19;130;1287;389;257;132
TANGARÁ DA SERRA;19;131;1147;312;241;71
TANGARÁ DA SERRA;19;133;1171;323;246;77
TANGARÁ DA SERRA;19;134;1040;413;297;116
TANGARÁ DA SERRA;19;139;1465;292;217;75
TANGARÁ DA SERRA;19;141;1031;299;237;62
TANGARÁ DA SERRA;19;143;1139;328;239;89
TANGARÁ DA SERRA;19;144;1163;275;219;56
TANGARÁ DA SERRA;19;146;1279;317;209;108
TANGARÁ DA SERRA;19;147;1210;307;219;88
TANGARÁ DA SERRA;19;148;1325;309;227;82
TANGARÁ DA SERRA;19;149;1058;395;286;109
TANGARÁ DA SERRA;19;154;1325;157;109;48
TANGARÁ DA SERRA;19;155;1120;402;283;119
TANGARÁ DA SERRA;19;157;1040;413;291;122
TANGARÁ DA SERRA;19;158;1031;308;238;70
TANGARÁ DA SERRA;19;161;1171;309;220;89
TANGARÁ DA SERRA;19;163;1171;325;252;73
TANGARÁ DA SERRA;19;164;1163;292;220;72
TANGARÁ DA SERRA;19;165;1139;327;245;82
TANGARÁ DA SERRA;19;166;1031;313;234;79
TANGARÁ DA SERRA;19;167;1015;343;260;83
TANGARÁ DA SERRA;19;170;1350;338;245;93
TANGARÁ DA SERRA;19;171;1333;387;301;86
TANGARÁ DA SERRA;19;172;1376;426;305;121
TANGARÁ DA SERRA;19;173;1368;352;268;84
TANGARÁ DA SERRA;19;174;1341;390;291;99
TANGARÁ DA SERRA;19;175;1058;389;285;104
TANGARÁ DA SERRA;19;176;1384;371;274;97
TANGARÁ DA SERRA;19;178;1120;396;297;99
TANGARÁ DA SERRA;19;179;1040;404;288;116
TANGARÁ DA SERRA;19;180;1333;400;307;93
TANGARÁ DA SERRA;19;181;1287;364;250;114
TANGARÁ DA SERRA;19;182;1350;338;234;104
TANGARÁ DA SERRA;19;185;1376;425;311;114
TANGARÁ DA SERRA;19;186;1341;380;265;115
TANGARÁ DA SERRA;19;188;1279;330;217;113
TANGARÁ DA SERRA;19;189;1155;349;253;96
TANGARÁ DA SERRA;19;190;1392;274;205;69
TANGARÁ DA SERRA;19;191;1058;396;292;104
TANGARÁ DA SERRA;19;193;1368;351;267;84
TANGARÁ DA SERRA;19;194;1040;409;286;123
TANGARÁ DA SERRA;19;196;1384;376;284;92
TANGARÁ DA SERRA;19;198;1350;344;237;107
TANGARÁ DA SERRA;19;200;1333;382;317;65
TANGARÁ DA SERRA;19;201;1376;431;305;126
TANGARÁ DA SERRA;19;202;1155;356;251;105
TANGARÁ DA SERRA;19;203;1341;393;258;135
TANGARÁ DA SERRA;19;204;1384;376;272;104
TANGARÁ DA SERRA;19;205;1350;321;222;99
TANGARÁ DA SERRA;19;206;1368;355;261;94
TANGARÁ DA SERRA;19;207;1333;403;306;97
TANGARÁ DA SERRA;19;208;1376;419;295;124
TANGARÁ DA SERRA;19;209;1058;378;278;100
TANGARÁ DA SERRA;19;210;1040;404;310;94
TANGARÁ DA SERRA;19;211;1384;372;258;114
TANGARÁ DA SERRA;19;212;1171;320;239;81
TANGARÁ DA SERRA;19;213;1350;354;243;111
TANGARÁ DA SERRA;19;214;1465;282;209;73
TANGARÁ DA SERRA;19;215;1287;369;253;116
TANGARÁ DA SERRA;19;216;1341;381;258;123
TANGARÁ DA SERRA;19;217;1120;402;277;125
TANGARÁ DA SERRA;19;218;1333;391;288;103
TANGARÁ DA SERRA;19;219;1384;383;268;115
TANGARÁ DA SERRA;19;220;1058;378;273;105
TANGARÁ DA SERRA;19;221;1171;331;227;104
TANGARÁ DA SERRA;19;222;1422;317;228;89
TANGARÁ DA SERRA;19;223;1414;342;257;85
TANGARÁ DA SERRA;19;224;1430;436;337;99
TANGARÁ DA SERRA;19;224;1430;435;337;98
TANGARÁ DA SERRA;19;226;1465;224;151;73
TANGARÁ DA SERRA;19;227;1350;327;234;93
TANGARÁ DA SERRA;19;228;1414;345;253;92
TANGARÁ DA SERRA;19;229;1368;352;261;91
TANGARÁ DA SERRA;19;230;1171;326;221;105
TANGARÁ DA SERRA;19;231;1350;324;224;100
TANGARÁ DA SERRA;19;232;1414;342;250;92
TANGARÁ DA SERRA;19;233;1465;201;156;45
TANGARÁ DA SERRA;19;234;1503;359;266;93
TANGARÁ DA SERRA;19;235;1040;387;276;111
TANGARÁ DA SERRA;19;236;1376;393;298;95
TANGARÁ DA SERRA;19;237;1120;384;280;104
TANGARÁ DA SERRA;19;238;1333;382;290;92
TANGARÁ DA SERRA;19;239;1015;324;255;69
TANGARÁ DA SERRA;19;240;1384;350;237;113
TANGARÁ DA SERRA;19;241;1350;311;203;108
NOVA OLÍMPIA;19;242;1112;238;183;55
NOVA OLÍMPIA;19;243;1112;238;186;52
NOVA OLÍMPIA;19;244;1112;232;175;57
NOVA OLÍMPIA;19;245;1112;240;181;59
NOVA OLÍMPIA;19;246;1112;240;186;54
NOVA OLÍMPIA;19;247;1023;248;180;68
NOVA OLÍMPIA;19;248;1023;252;186;66
NOVA OLÍMPIA;19;249;1023;256;198;58
NOVA OLÍMPIA;19;250;1023;250;187;63
NOVA OLÍMPIA;19;251;1023;252;194;58
NOVA OLÍMPIA;19;252;1040;283;222;61
NOVA OLÍMPIA;19;253;1040;281;217;64
NOVA OLÍMPIA;19;254;1040;285;225;60
NOVA OLÍMPIA;19;255;1040;286;208;78
NOVA OLÍMPIA;19;256;1040;284;225;59
NOVA OLÍMPIA;19;257;1023;266;181;85
NOVA OLÍMPIA;19;258;1023;255;187;68
NOVA OLÍMPIA;19;259;1023;248;186;62
NOVA OLÍMPIA;19;260;1023;263;202;61
NOVA OLÍMPIA;19;261;1066;247;184;63
NOVA OLÍMPIA;19;262;1066;235;173;62
NOVA OLÍMPIA;19;263;1066;246;183;63
NOVA OLÍMPIA;19;264;1066;238;175;63
NOVA OLÍMPIA;19;265;1066;247;181;66
NOVA OLÍMPIA;19;266;1066;236;189;47
NOVA OLÍMPIA;19;267;1074;266;208;58
NOVA OLÍMPIA;19;268;1074;270;209;61
NOVA OLÍMPIA;19;269;1074;272;213;59
NOVA OLÍMPIA;19;270;1074;267;202;65
NOVA OLÍMPIA;19;271;1074;265;212;53
NOVA OLÍMPIA;19;272;1074;264;194;70
NOVA OLÍMPIA;19;273;1074;278;212;66
NOVA OLÍMPIA;19;274;1082;370;288;82
NOVA OLÍMPIA;19;275;1082;376;273;103
NOVA OLÍMPIA;19;276;1082;384;277;107
NOVA OLÍMPIA;19;277;1082;368;293;75
NOVA OLÍMPIA;19;278;1104;329;249;80
NOVA OLÍMPIA;19;279;1104;330;243;87
NOVA OLÍMPIA;19;280;1104;330;242;88
NOVA OLÍMPIA;19;281;1104;323;243;80
NOVA OLÍMPIA;19;282;1090;400;224;176
TANGARÁ DA SERRA;19;283;1341;352;237;115
NOVA OLÍMPIA;19;284;1104;334;250;84
TANGARÁ DA SERRA;19;285;1503;334;247;87
TANGARÁ DA SERRA;19;286;1414;349;260;89
TANGARÁ DA SERRA;19;287;1350;291;218;73
TANGARÁ DA SERRA;19;288;1392;237;191;46
TANGARÁ DA SERRA;19;289;1279;289;207;82
TANGARÁ DA SERRA;19;290;1120;359;248;111
TANGARÁ DA SERRA;19;291;1422;352;271;81
TANGARÁ DA SERRA;19;292;1341;357;249;108
TANGARÁ DA SERRA;19;293;1040;368;251;117
TANGARÁ DA SERRA;19;294;1503;330;254;76
TANGARÁ DA SERRA;19;295;1333;363;269;94
TANGARÁ DA SERRA;19;296;1490;385;288;97
TANGARÁ DA SERRA;19;297;1287;367;262;105
TANGARÁ DA SERRA;19;298;1490;391;300;91
TANGARÁ DA SERRA;19;299;1368;327;236;91
TANGARÁ DA SERRA;19;300;1341;353;265;88
TANGARÁ DA SERRA;19;301;1155;327;252;75
TANGARÁ DA SERRA;19;302;1503;342;279;63
TANGARÁ DA SERRA;19;303;1376;384;281;103
TANGARÁ DA SERRA;19;304;1422;290;216;74
TANGARÁ DA SERRA;19;305;1333;365;293;72
TANGARÁ DA SERRA;19;306;1490;388;308;80
TANGARÁ DA SERRA;19;307;1384;341;240;101
TANGARÁ DA SERRA;19;308;1414;308;238;70
TANGARÁ DA SERRA;19;309;1490;390;257;133
TANGARÁ DA SERRA;19;310;1287;337;250;87
NOVA OLÍMPIA;19;311;1082;379;309;70
NOVA OLÍMPIA;19;312;1082;356;264;92
TANGARÁ DA SERRA;19;314;1490;390;275;115
TANGARÁ DA SERRA;19;315;1503;213;187;26
VÁRZEA GRANDE;20;29;2127;228;186;42
VÁRZEA GRANDE;20;31;2127;233;208;25
VÁRZEA GRANDE;20;41;2135;315;268;47
VÁRZEA GRANDE;20;53;1112;319;275;44
VÁRZEA GRANDE;20;57;1112;321;273;48
VÁRZEA GRANDE;20;59;1112;320;275;45
VÁRZEA GRANDE;20;261;2135;309;276;33
VÁRZEA GRANDE;20;324;2135;315;258;57
VÁRZEA GRANDE;20;339;1554;201;166;35
VÁRZEA GRANDE;20;340;1554;198;170;28
VÁRZEA GRANDE;20;341;1546;399;343;56
VÁRZEA GRANDE;20;342;1546;394;328;66
VÁRZEA GRANDE;20;343;1546;391;325;66
VÁRZEA GRANDE;20;344;1546;387;320;67
VÁRZEA GRANDE;20;345;1546;385;327;58
VÁRZEA GRANDE;20;346;1546;386;317;69
VÁRZEA GRANDE;20;347;1554;200;171;29
VÁRZEA GRANDE;20;348;1554;198;168;30
VÁRZEA GRANDE;20;349;1554;200;175;25
VÁRZEA GRANDE;20;350;1929;219;181;38
VÁRZEA GRANDE;20;351;1929;220;189;31
VÁRZEA GRANDE;20;352;1570;401;314;87
VÁRZEA GRANDE;20;353;1570;397;293;104
VÁRZEA GRANDE;20;354;1570;451;347;104
VÁRZEA GRANDE;20;355;1589;354;288;66
VÁRZEA GRANDE;20;356;1589;347;296;51
VÁRZEA GRANDE;20;357;1589;345;291;54
VÁRZEA GRANDE;20;358;1589;346;292;54
VÁRZEA GRANDE;20;359;1589;348;283;65
VÁRZEA GRANDE;20;360;1589;347;287;60
VÁRZEA GRANDE;20;361;1589;345;279;66
VÁRZEA GRANDE;20;362;1597;333;272;61
VÁRZEA GRANDE;20;364;1597;332;273;59
VÁRZEA GRANDE;20;366;1597;330;277;53
VÁRZEA GRANDE;20;368;1597;335;268;67
VÁRZEA GRANDE;20;370;1597;338;272;66
VÁRZEA GRANDE;20;372;1597;331;280;51
VÁRZEA GRANDE;20;374;1597;331;276;55
VÁRZEA GRANDE;20;376;1597;322;271;51
VÁRZEA GRANDE;20;378;1600;251;214;37
VÁRZEA GRANDE;20;379;1600;248;209;39
VÁRZEA GRANDE;20;380;1600;249;205;44
VÁRZEA GRANDE;20;381;1600;272;225;47
VÁRZEA GRANDE;20;382;1600;237;207;30
VÁRZEA GRANDE;20;383;1600;247;220;27
VÁRZEA GRANDE;20;384;1600;244;215;29
VÁRZEA GRANDE;20;385;1619;240;197;43
VÁRZEA GRANDE;20;386;1619;240;200;40
VÁRZEA GRANDE;20;387;1619;238;211;27
VÁRZEA GRANDE;20;388;1619;240;207;33
VÁRZEA GRANDE;20;389;1619;237;204;33
VÁRZEA GRANDE;20;390;1619;241;211;30
VÁRZEA GRANDE;20;391;1619;240;217;23
VÁRZEA GRANDE;20;392;1619;242;214;28
VÁRZEA GRANDE;20;393;1627;205;167;38
VÁRZEA GRANDE;20;394;1627;205;179;26
VÁRZEA GRANDE;20;395;1627;203;158;45
VÁRZEA GRANDE;20;396;1627;204;164;40
VÁRZEA GRANDE;20;397;1635;318;265;53
VÁRZEA GRANDE;20;398;1635;305;247;58
VÁRZEA GRANDE;20;399;1635;312;255;57
VÁRZEA GRANDE;20;400;1643;240;203;37
VÁRZEA GRANDE;20;401;1651;404;337;67
VÁRZEA GRANDE;20;402;1651;400;317;83
VÁRZEA GRANDE;20;403;1635;310;270;40
VÁRZEA GRANDE;20;404;1635;316;261;55
VÁRZEA GRANDE;20;405;1678;318;268;50
VÁRZEA GRANDE;20;406;1678;314;267;47
VÁRZEA GRANDE;20;407;1678;310;252;58
VÁRZEA GRANDE;20;408;1686;259;228;31
VÁRZEA GRANDE;20;409;1686;259;232;27
VÁRZEA GRANDE;20;410;1694;292;240;52
VÁRZEA GRANDE;20;411;1694;282;250;32
VÁRZEA GRANDE;20;412;1694;281;231;50
VÁRZEA GRANDE;20;413;1708;389;314;75
VÁRZEA GRANDE;20;414;1708;384;317;67
VÁRZEA GRANDE;20;415;1708;386;319;67
VÁRZEA GRANDE;20;416;1708;389;309;80
VÁRZEA GRANDE;20;417;1708;387;330;57
VÁRZEA GRANDE;20;418;1716;364;293;71
VÁRZEA GRANDE;20;419;1716;363;300;63
VÁRZEA GRANDE;20;420;1716;369;320;49
VÁRZEA GRANDE;20;421;1716;364;319;45
VÁRZEA GRANDE;20;422;1716;363;308;55
VÁRZEA GRANDE;20;429;1759;357;304;53
VÁRZEA GRANDE;20;430;1759;348;276;72
VÁRZEA GRANDE;20;431;1759;347;280;67
VÁRZEA GRANDE;20;432;1759;356;289;67
VÁRZEA GRANDE;20;433;1759;348;269;79
VÁRZEA GRANDE;20;434;1759;349;285;64
VÁRZEA GRANDE;20;435;1759;348;276;72
VÁRZEA GRANDE;20;436;1767;272;230;42
VÁRZEA GRANDE;20;437;1767;262;228;34
VÁRZEA GRANDE;20;438;1767;272;233;39
VÁRZEA GRANDE;20;439;1767;269;225;44
VÁRZEA GRANDE;20;440;1767;267;217;50
VÁRZEA GRANDE;20;441;1775;210;178;32
VÁRZEA GRANDE;20;442;1775;203;178;25
VÁRZEA GRANDE;20;443;1775;207;180;27
VÁRZEA GRANDE;20;444;1775;197;172;25
VÁRZEA GRANDE;20;445;1600;227;195;32
VÁRZEA GRANDE;20;446;1600;233;202;31
VÁRZEA GRANDE;20;447;1600;229;200;29
VÁRZEA GRANDE;20;448;1643;159;131;28
VÁRZEA GRANDE;20;449;1805;291;249;42
VÁRZEA GRANDE;20;450;1678;312;272;40
VÁRZEA GRANDE;20;451;1821;297;254;43
VÁRZEA GRANDE;20;452;1821;287;251;36
VÁRZEA GRANDE;20;453;1821;290;237;53
VÁRZEA GRANDE;20;454;1821;290;250;40
VÁRZEA GRANDE;20;455;1821;285;238;47
VÁRZEA GRANDE;20;456;1821;291;263;28
VÁRZEA GRANDE;20;457;1830;394;322;72
VÁRZEA GRANDE;20;458;1830;391;310;81
VÁRZEA GRANDE;20;459;1830;391;320;71
VÁRZEA GRANDE;20;460;1830;394;317;77
VÁRZEA GRANDE;20;461;1830;393;325;68
VÁRZEA GRANDE;20;462;1830;391;329;62
VÁRZEA GRANDE;20;464;1830;396;335;61
VÁRZEA GRANDE;20;465;1830;390;328;62
VÁRZEA GRANDE;20;466;1848;344;284;60
VÁRZEA GRANDE;20;467;1848;343;288;55
VÁRZEA GRANDE;20;468;1848;345;288;57
VÁRZEA GRANDE;20;469;1848;341;287;54
VÁRZEA GRANDE;20;470;1848;338;296;42
VÁRZEA GRANDE;20;471;1848;342;288;54
VÁRZEA GRANDE;20;472;1856;344;282;62
VÁRZEA GRANDE;20;473;1856;341;277;64
VÁRZEA GRANDE;20;474;1856;343;286;57
VÁRZEA GRANDE;20;475;1864;337;292;45
VÁRZEA GRANDE;20;476;1864;331;284;47
VÁRZEA GRANDE;20;477;1864;331;272;59
VÁRZEA GRANDE;20;479;1864;328;280;48
VÁRZEA GRANDE;20;480;1864;330;277;53
VÁRZEA GRANDE;20;481;1872;315;270;45
VÁRZEA GRANDE;20;482;1872;310;262;48
VÁRZEA GRANDE;20;483;1872;310;255;55
VÁRZEA GRANDE;20;484;1872;312;266;46
VÁRZEA GRANDE;20;485;1872;305;261;44
VÁRZEA GRANDE;20;486;1872;308;254;54
VÁRZEA GRANDE;20;487;1880;392;323;69
VÁRZEA GRANDE;20;488;1880;393;322;71
VÁRZEA GRANDE;20;489;1899;352;289;63
VÁRZEA GRANDE;20;489;1899;351;288;63
VÁRZEA GRANDE;20;490;1635;314;267;47
VÁRZEA GRANDE;20;491;1619;233;194;39
VÁRZEA GRANDE;20;492;1899;348;290;58
VÁRZEA GRANDE;20;493;1872;306;260;46
VÁRZEA GRANDE;20;494;1880;389;321;68
VÁRZEA GRANDE;20;495;1775;208;185;23
VÁRZEA GRANDE;20;496;1651;396;324;72
VÁRZEA GRANDE;20;497;1716;363;306;57
VÁRZEA GRANDE;20;498;1864;331;270;61
VÁRZEA GRANDE;20;499;1805;284;240;44
VÁRZEA GRANDE;20;500;1767;268;213;55
VÁRZEA GRANDE;20;501;1872;306;248;58
VÁRZEA GRANDE;20;502;1848;343;272;71
VÁRZEA GRANDE;20;504;1546;396;325;71
VÁRZEA GRANDE;20;505;1775;196;170;26
VÁRZEA GRANDE;20;506;1759;348;279;69
VÁRZEA GRANDE;20;507;1856;343;274;69
VÁRZEA GRANDE;20;508;1902;394;321;73
VÁRZEA GRANDE;20;509;1589;346;283;63
VÁRZEA GRANDE;20;510;1880;386;314;72
VÁRZEA GRANDE;20;511;1899;348;292;56
VÁRZEA GRANDE;20;512;1902;390;295;95
VÁRZEA GRANDE;20;514;1872;308;266;42
VÁRZEA GRANDE;20;515;1708;385;329;56
VÁRZEA GRANDE;20;516;1600;284;232;52
VÁRZEA GRANDE;20;517;1856;346;283;63
VÁRZEA GRANDE;20;518;1775;207;172;35
VÁRZEA GRANDE;20;520;1902;392;313;79
VÁRZEA GRANDE;20;521;1716;368;305;63
VÁRZEA GRANDE;20;522;1589;345;276;69
VÁRZEA GRANDE;20;523;1694;286;237;49
VÁRZEA GRANDE;20;525;1686;258;219;39
VÁRZEA GRANDE;20;526;1546;389;316;73
VÁRZEA GRANDE;20;527;1937;382;322;60
VÁRZEA GRANDE;20;528;1945;400;312;88
VÁRZEA GRANDE;20;529;1945;392;310;82
VÁRZEA GRANDE;20;530;1937;380;322;58
VÁRZEA GRANDE;20;532;1945;395;327;68
VÁRZEA GRANDE;20;533;1589;378;291;87
VÁRZEA GRANDE;20;534;1880;395;316;79
VÁRZEA GRANDE;20;535;1970;213;172;41
VÁRZEA GRANDE;20;536;1970;217;157;60
VÁRZEA GRANDE;20;537;1988;74;44;30
VÁRZEA GRANDE;20;538;1996;416;353;63
VÁRZEA GRANDE;20;540;1996;391;320;71
VÁRZEA GRANDE;20;541;1996;394;323;71
VÁRZEA GRANDE;20;542;2003;362;278;84
VÁRZEA GRANDE;20;543;2003;361;286;75
VÁRZEA GRANDE;20;544;2003;352;283;69
VÁRZEA GRANDE;20;545;2003;359;294;65
VÁRZEA GRANDE;20;546;2003;365;298;67
VÁRZEA GRANDE;20;547;2011;199;161;38
VÁRZEA GRANDE;20;548;2020;302;257;45
VÁRZEA GRANDE;20;549;2020;303;273;30
VÁRZEA GRANDE;20;550;2020;302;263;39
VÁRZEA GRANDE;20;551;2020;296;268;28
VÁRZEA GRANDE;20;553;2020;304;264;40
VÁRZEA GRANDE;20;554;2020;302;248;54
VÁRZEA GRANDE;20;555;2038;324;274;50
VÁRZEA GRANDE;20;556;2038;317;268;49
VÁRZEA GRANDE;20;557;2038;321;271;50
VÁRZEA GRANDE;20;558;2038;320;273;47
VÁRZEA GRANDE;20;559;2038;321;269;52
VÁRZEA GRANDE;20;560;2038;319;274;45
VÁRZEA GRANDE;20;561;2038;318;268;50
VÁRZEA GRANDE;20;562;2038;322;264;58
VÁRZEA GRANDE;20;563;2038;319;262;57
VÁRZEA GRANDE;20;564;2046;397;322;75
VÁRZEA GRANDE;20;565;2046;392;307;85
VÁRZEA GRANDE;20;566;2054;265;211;54
VÁRZEA GRANDE;20;567;2062;381;312;69
VÁRZEA GRANDE;20;568;2062;378;305;73
VÁRZEA GRANDE;20;569;2062;382;301;81
VÁRZEA GRANDE;20;570;2062;378;295;83
VÁRZEA GRANDE;20;571;2070;376;302;74
VÁRZEA GRANDE;20;572;2070;374;299;75
VÁRZEA GRANDE;20;573;2070;367;307;60
VÁRZEA GRANDE;20;574;2070;373;297;76
VÁRZEA GRANDE;20;575;2070;371;299;72
VÁRZEA GRANDE;20;576;2089;151;127;24
VÁRZEA GRANDE;20;577;2097;391;304;87
VÁRZEA GRANDE;20;578;2097;381;311;70
VÁRZEA GRANDE;20;579;2097;380;295;85
VÁRZEA GRANDE;20;580;2097;376;301;75
VÁRZEA GRANDE;20;581;2097;376;294;82
VÁRZEA GRANDE;20;582;2097;381;305;76
VÁRZEA GRANDE;20;583;2097;379;296;83
VÁRZEA GRANDE;20;584;2097;376;297;79
VÁRZEA GRANDE;20;585;2097;385;299;86
VÁRZEA GRANDE;20;586;2097;381;279;102
NOSSA SENHORA DO LIVRAMENTO;20;587;1066;353;294;59
NOSSA SENHORA DO LIVRAMENTO;20;588;1066;354;300;54
NOSSA SENHORA DO LIVRAMENTO;20;589;1066;352;288;64
NOSSA SENHORA DO LIVRAMENTO;20;590;1066;351;299;52
NOSSA SENHORA DO LIVRAMENTO;20;591;1066;350;288;62
NOSSA SENHORA DO LIVRAMENTO;20;593;1066;354;287;67
NOSSA SENHORA DO LIVRAMENTO;20;594;1074;247;206;41
NOSSA SENHORA DO LIVRAMENTO;20;595;1074;244;206;38
NOSSA SENHORA DO LIVRAMENTO;20;596;1074;242;206;36
NOSSA SENHORA DO LIVRAMENTO;20;597;1074;244;201;43
NOSSA SENHORA DO LIVRAMENTO;20;598;1074;245;201;44
NOSSA SENHORA DO LIVRAMENTO;20;599;1074;238;205;33
NOSSA SENHORA DO LIVRAMENTO;20;600;1074;243;198;45
NOSSA SENHORA DO LIVRAMENTO;20;601;1074;242;204;38
NOSSA SENHORA DO LIVRAMENTO;20;602;1112;325;275;50
NOSSA SENHORA DO LIVRAMENTO;20;603;1112;363;303;60
NOSSA SENHORA DO LIVRAMENTO;20;604;1244;146;91;55
NOSSA SENHORA DO LIVRAMENTO;20;605;1147;235;185;50
NOSSA SENHORA DO LIVRAMENTO;20;606;1163;105;78;27
NOSSA SENHORA DO LIVRAMENTO;20;607;1163;103;86;17
NOSSA SENHORA DO LIVRAMENTO;20;608;1163;105;82;23
NOSSA SENHORA DO LIVRAMENTO;20;609;1171;164;127;37
NOSSA SENHORA DO LIVRAMENTO;20;610;1171;156;123;33
NOSSA SENHORA DO LIVRAMENTO;20;611;1171;158;116;42
NOSSA SENHORA DO LIVRAMENTO;20;612;1180;192;158;34
NOSSA SENHORA DO LIVRAMENTO;20;613;1180;195;154;41
NOSSA SENHORA DO LIVRAMENTO;20;614;1210;440;357;83
NOSSA SENHORA DO LIVRAMENTO;20;615;1228;66;57;9
NOSSA SENHORA DO LIVRAMENTO;20;616;1236;315;251;64
NOSSA SENHORA DO LIVRAMENTO;20;617;1244;146;107;39
NOSSA SENHORA DO LIVRAMENTO;20;618;1252;198;179;19
NOSSA SENHORA DO LIVRAMENTO;20;619;1252;204;178;26
NOSSA SENHORA DO LIVRAMENTO;20;620;1333;247;201;46
NOSSA SENHORA DO LIVRAMENTO;20;621;1333;243;190;53
NOSSA SENHORA DO LIVRAMENTO;20;622;1074;244;194;50
NOSSA SENHORA DO LIVRAMENTO;20;623;1074;241;195;46
NOSSA SENHORA DO LIVRAMENTO;20;624;1066;353;284;69
NOSSA SENHORA DO LIVRAMENTO;20;625;1066;347;285;62
NOSSA SENHORA DO LIVRAMENTO;20;626;1368;142;104;38
NOSSA SENHORA DO LIVRAMENTO;20;627;1368;137;114;23
NOSSA SENHORA DO LIVRAMENTO;20;628;1376;192;144;48
NOSSA SENHORA DO LIVRAMENTO;20;629;1392;204;181;23
NOSSA SENHORA DO LIVRAMENTO;20;630;1392;203;170;33
NOSSA SENHORA DO LIVRAMENTO;20;631;1392;198;165;33
NOSSA SENHORA DO LIVRAMENTO;20;632;1406;124;107;17
NOSSA SENHORA DO LIVRAMENTO;20;632;1406;123;106;17
NOSSA SENHORA DO LIVRAMENTO;20;633;1406;122;109;13
NOSSA SENHORA DO LIVRAMENTO;20;634;1414;183;139;44
NOSSA SENHORA DO LIVRAMENTO;20;635;1414;184;139;45
NOSSA SENHORA DO LIVRAMENTO;20;636;1414;179;128;51
NOSSA SENHORA DO LIVRAMENTO;20;637;1414;181;153;28
NOSSA SENHORA DO LIVRAMENTO;20;638;1422;322;242;80
NOSSA SENHORA DO LIVRAMENTO;20;639;1430;132;104;28
NOSSA SENHORA DO LIVRAMENTO;20;640;1449;99;86;13
VÁRZEA GRANDE;20;641;2100;356;277;79
VÁRZEA GRANDE;20;642;2100;356;264;92
VÁRZEA GRANDE;20;643;2100;357;270;87
VÁRZEA GRANDE;20;644;2100;354;275;79
VÁRZEA GRANDE;20;645;2100;348;262;86
VÁRZEA GRANDE;20;646;2100;348;265;83
VÁRZEA GRANDE;20;647;2119;197;154;43
VÁRZEA GRANDE;20;647;2119;196;153;43
VÁRZEA GRANDE;20;648;2119;193;156;37
VÁRZEA GRANDE;20;649;2119;196;166;30
VÁRZEA GRANDE;20;650;2119;194;170;24
VÁRZEA GRANDE;20;651;2119;193;159;34
VÁRZEA GRANDE;20;652;2119;195;157;38
VÁRZEA GRANDE;20;653;2119;372;309;63
VÁRZEA GRANDE;20;653;2119;253;216;37
VÁRZEA GRANDE;20;654;1902;397;328;69
VÁRZEA GRANDE;20;655;1872;355;285;70
VÁRZEA GRANDE;20;656;1937;379;301;78
VÁRZEA GRANDE;20;657;2038;345;269;76
VÁRZEA GRANDE;20;658;2003;364;288;76
VÁRZEA GRANDE;20;659;1945;395;313;82
VÁRZEA GRANDE;20;660;1899;346;273;73
VÁRZEA GRANDE;20;661;1902;396;308;88
VÁRZEA GRANDE;20;662;2062;378;269;109
VÁRZEA GRANDE;20;663;1635;317;250;67
VÁRZEA GRANDE;20;664;1945;397;304;93
VÁRZEA GRANDE;20;665;2143;253;213;40
VÁRZEA GRANDE;20;666;2143;251;210;41
VÁRZEA GRANDE;20;667;2143;248;204;44
VÁRZEA GRANDE;20;669;1937;378;335;43
NOSSA SENHORA DO LIVRAMENTO;20;670;1414;182;160;22
VÁRZEA GRANDE;20;671;2046;391;320;71
VÁRZEA GRANDE;20;672;1902;395;310;85
VÁRZEA GRANDE;20;674;1945;395;326;69
VÁRZEA GRANDE;20;676;1880;132;113;19
VÁRZEA GRANDE;20;677;2046;160;129;31
VÁRZEA GRANDE;20;678;1546;171;134;37
ITANHANGÁ;21;99;1015;285;219;66
ITANHANGÁ;21;100;1015;292;224;68
ITANHANGÁ;21;101;1058;317;228;89
ITANHANGÁ;21;102;1031;270;208;62
ITANHANGÁ;21;103;1031;280;208;72
ITANHANGÁ;21;104;1031;285;196;89
ITANHANGÁ;21;105;1058;308;244;64
ITANHANGÁ;21;106;1058;309;231;78
ITANHANGÁ;21;107;1058;307;240;67
ITANHANGÁ;21;108;1058;313;235;78
ITANHANGÁ;21;110;1040;335;253;82
TAPURAH;21;111;1015;364;279;85
TAPURAH;21;112;1015;361;280;81
TAPURAH;21;113;1015;374;285;89
TAPURAH;21;114;1015;358;288;70
TAPURAH;21;115;1015;367;277;90
TAPURAH;21;116;1015;358;275;83
TAPURAH;21;117;1040;377;267;110
TAPURAH;21;118;1040;367;266;101
TAPURAH;21;119;1040;360;261;99
TAPURAH;21;120;1040;357;260;97
TAPURAH;21;121;1040;368;267;101
TAPURAH;21;122;1023;223;184;39
TAPURAH;21;123;1031;262;170;92
TAPURAH;21;124;1031;247;180;67
LUCAS DO RIO VERDE;21;125;1112;354;286;68
LUCAS DO RIO VERDE;21;126;1112;362;283;79
LUCAS DO RIO VERDE;21;127;1112;363;295;68
LUCAS DO RIO VERDE;21;128;1112;371;289;82
LUCAS DO RIO VERDE;21;129;1112;361;283;78
LUCAS DO RIO VERDE;21;130;1147;381;307;74
LUCAS DO RIO VERDE;21;131;1147;382;292;90
LUCAS DO RIO VERDE;21;132;1147;382;312;70
LUCAS DO RIO VERDE;21;133;1112;281;243;38
LUCAS DO RIO VERDE;21;134;1112;281;232;49
LUCAS DO RIO VERDE;21;135;1112;285;233;52
LUCAS DO RIO VERDE;21;136;1112;281;228;53
LUCAS DO RIO VERDE;21;137;1112;284;235;49
LUCAS DO RIO VERDE;21;138;1031;389;298;91
LUCAS DO RIO VERDE;21;139;1031;391;306;85
LUCAS DO RIO VERDE;21;140;1031;396;308;88
LUCAS DO RIO VERDE;21;141;1031;394;310;84
LUCAS DO RIO VERDE;21;142;1031;389;278;111
LUCAS DO RIO VERDE;21;143;1139;388;291;97
LUCAS DO RIO VERDE;21;144;1139;391;304;87
LUCAS DO RIO VERDE;21;145;1147;383;306;77
LUCAS DO RIO VERDE;21;146;1147;383;311;72
LUCAS DO RIO VERDE;21;147;1058;251;208;43
LUCAS DO RIO VERDE;21;148;1066;383;285;98
LUCAS DO RIO VERDE;21;149;1066;369;279;90
LUCAS DO RIO VERDE;21;150;1066;381;288;93
LUCAS DO RIO VERDE;21;151;1066;383;304;79
LUCAS DO RIO VERDE;21;152;1066;370;284;86
LUCAS DO RIO VERDE;21;153;1066;378;285;93
LUCAS DO RIO VERDE;21;154;1066;372;267;105
LUCAS DO RIO VERDE;21;155;1066;378;287;91
LUCAS DO RIO VERDE;21;156;1104;368;267;101
LUCAS DO RIO VERDE;21;157;1104;363;267;96
LUCAS DO RIO VERDE;21;158;1074;389;288;101
LUCAS DO RIO VERDE;21;159;1082;269;210;59
LUCAS DO RIO VERDE;21;160;1082;279;211;68
LUCAS DO RIO VERDE;21;161;1082;273;214;59
LUCAS DO RIO VERDE;21;162;1082;275;205;70
LUCAS DO RIO VERDE;21;163;1082;275;215;60
LUCAS DO RIO VERDE;21;164;1082;277;209;68
LUCAS DO RIO VERDE;21;164;1082;276;208;68
LUCAS DO RIO VERDE;21;165;1082;275;209;66
LUCAS DO RIO VERDE;21;166;1082;271;207;64
LUCAS DO RIO VERDE;21;167;1090;359;265;94
LUCAS DO RIO VERDE;21;168;1090;359;270;89
LUCAS DO RIO VERDE;21;169;1090;356;282;74
LUCAS DO RIO VERDE;21;170;1104;367;280;87
LUCAS DO RIO VERDE;21;171;1104;363;276;87
LUCAS DO RIO VERDE;21;172;1104;370;281;89
LUCAS DO RIO VERDE;21;173;1139;392;295;97
LUCAS DO RIO VERDE;21;174;1139;392;292;100
LUCAS DO RIO VERDE;21;175;1104;372;276;96
LUCAS DO RIO VERDE;21;176;1147;384;302;82
LUCAS DO RIO VERDE;21;177;1104;375;274;101
LUCAS DO RIO VERDE;21;178;1104;372;271;101
ITANHANGÁ;21;179;1058;310;229;81
TAPURAH;21;180;1040;359;265;94
LUCAS DO RIO VERDE;21;182;1104;369;273;96
TAPURAH;21;183;1040;370;269;101
LUCAS DO RIO VERDE;21;184;1082;276;210;66
LUCAS DO RIO VERDE;21;185;1112;280;227;53
TAPURAH;21;186;1023;228;167;61
ITANHANGÁ;21;187;1031;279;193;86
LUCAS DO RIO VERDE;21;188;1139;389;308;81
LUCAS DO RIO VERDE;21;189;1147;378;303;75
TAPURAH;21;190;1040;367;252;115
LUCAS DO RIO VERDE;21;192;1139;393;301;92
LUCAS DO RIO VERDE;21;193;1090;353;252;101
TAPURAH;21;194;1040;360;253;107
LUCAS DO RIO VERDE;21;195;1147;380;291;89
LUCAS DO RIO VERDE;21;196;1139;393;288;105
ITANHANGÁ;21;197;1058;312;220;92
LUCAS DO RIO VERDE;21;198;1139;389;298;91
LUCAS DO RIO VERDE;21;199;1147;380;307;73
LUCAS DO RIO VERDE;21;200;1090;351;248;103
LUCAS DO RIO VERDE;21;202;1139;385;291;94
LUCAS DO RIO VERDE;21;203;1031;376;288;88
LUCAS DO RIO VERDE;21;204;1180;384;290;94
LUCAS DO RIO VERDE;21;205;1163;359;254;105
LUCAS DO RIO VERDE;21;206;1082;273;206;67
LUCAS DO RIO VERDE;21;207;1180;381;283;98
LUCAS DO RIO VERDE;21;208;1163;372;287;85
LUCAS DO RIO VERDE;21;209;1104;368;281;87
LUCAS DO RIO VERDE;21;210;1180;389;290;99
LUCAS DO RIO VERDE;21;211;1180;379;268;111
LUCAS DO RIO VERDE;21;212;1104;367;261;106
LUCAS DO RIO VERDE;21;213;1058;243;170;73
ITANHANGÁ;21;214;1031;293;199;94
LUCAS DO RIO VERDE;21;215;1163;356;263;93
LUCAS DO RIO VERDE;21;216;1112;352;265;87
LUCAS DO RIO VERDE;21;217;1180;384;288;96
LUCAS DO RIO VERDE;21;218;1031;385;263;122
LUCAS DO RIO VERDE;21;219;1163;369;280;89
LUCAS DO RIO VERDE;21;220;1180;377;271;106
LUCAS DO RIO VERDE;21;221;1031;384;268;116
LUCAS DO RIO VERDE;21;222;1104;367;257;110
LUCAS DO RIO VERDE;21;223;1163;354;261;93
LUCAS DO RIO VERDE;21;224;1180;382;274;108
TAPURAH;21;225;1015;376;279;97
LUCAS DO RIO VERDE;21;226;1031;382;262;120
LUCAS DO RIO VERDE;21;227;1112;280;215;65
LUCAS DO RIO VERDE;21;228;1163;355;251;104
LUCAS DO RIO VERDE;21;229;1139;392;280;112
LUCAS DO RIO VERDE;21;230;1180;388;276;112
LUCAS DO RIO VERDE;21;231;1031;388;263;125
LUCAS DO RIO VERDE;21;232;1163;352;263;89
LUCAS DO RIO VERDE;21;233;1104;373;269;104
LUCAS DO RIO VERDE;21;234;1210;392;301;91
LUCAS DO RIO VERDE;21;235;1112;354;281;73
LUCAS DO RIO VERDE;21;236;1031;382;268;114
LUCAS DO RIO VERDE;21;237;1180;385;302;83
LUCAS DO RIO VERDE;21;238;1163;359;262;97
LUCAS DO RIO VERDE;21;239;1210;393;310;83
LUCAS DO RIO VERDE;21;239;1210;392;309;83
LUCAS DO RIO VERDE;21;240;1147;385;324;61
LUCAS DO RIO VERDE;21;241;1180;381;294;87
LUCAS DO RIO VERDE;21;242;1210;394;315;79
LUCAS DO RIO VERDE;21;243;1163;363;259;104
LUCAS DO RIO VERDE;21;244;1031;390;265;125
LUCAS DO RIO VERDE;21;245;1147;387;319;68
LUCAS DO RIO VERDE;21;246;1210;396;276;120
LUCAS DO RIO VERDE;21;247;1180;378;275;103
LUCAS DO RIO VERDE;21;248;1163;363;241;122
LUCAS DO RIO VERDE;21;249;1112;354;259;95
TAPURAH;21;250;1015;373;292;81
LUCAS DO RIO VERDE;21;251;1210;388;268;120
LUCAS DO RIO VERDE;21;252;1180;383;267;116
LUCAS DO RIO VERDE;21;253;1210;394;261;133
LUCAS DO RIO VERDE;21;254;1201;371;294;77
LUCAS DO RIO VERDE;21;255;1210;393;278;115
TAPURAH;21;256;1015;378;269;109
TAPURAH;21;257;1040;382;256;126
LUCAS DO RIO VERDE;21;258;1163;358;232;126
LUCAS DO RIO VERDE;21;259;1201;367;271;96
LUCAS DO RIO VERDE;21;260;1139;395;264;131
LUCAS DO RIO VERDE;21;261;1163;356;247;109
LUCAS DO RIO VERDE;21;262;1201;371;275;96
LUCAS DO RIO VERDE;21;263;1090;360;246;114
LUCAS DO RIO VERDE;21;264;1210;396;248;148
LUCAS DO RIO VERDE;21;265;1201;389;308;81
LUCAS DO RIO VERDE;21;266;1066;367;237;130
LUCAS DO RIO VERDE;21;268;1163;305;194;111
LUCAS DO RIO VERDE;21;269;1180;392;270;122
TAPURAH;21;270;1015;373;290;83
TAPURAH;21;271;1015;373;280;93
TAPURAH;21;272;1015;334;219;115
ITANHANGÁ;21;273;1031;364;281;83
ITANHANGÁ;21;274;1031;286;239;47
LUCAS DO RIO VERDE;21;275;1210;397;295;102
LUCAS DO RIO VERDE;21;276;1163;313;261;52
LUCAS DO RIO VERDE;21;277;1031;395;241;154
LUCAS DO RIO VERDE;21;278;1163;310;245;65
LUCAS DO RIO VERDE;21;279;1031;391;325;66
LUCAS DO RIO VERDE;21;280;1210;390;311;79
LUCAS DO RIO VERDE;21;281;1066;203;178;25
LUCAS DO RIO VERDE;21;282;1201;143;125;18
LUCAS DO RIO VERDE;21;283;1147;355;306;49
LUCAS DO RIO VERDE;21;284;1180;185;156;29
LUCAS DO RIO VERDE;21;285;1031;191;145;46
SINOP;22;1;1015;392;323;69
SINOP;22;1;1015;280;228;52
SINOP;22;2;1015;394;329;65
SINOP;22;2;1015;268;221;47
SINOP;22;3;1015;222;182;40
SINOP;22;4;1015;395;322;73
SINOP;22;4;1015;283;233;50
SINOP;22;5;1015;222;189;33
SINOP;22;6;1015;221;176;45
SINOP;22;7;1015;225;178;47
SINOP;22;8;1015;223;193;30
SINOP;22;9;1015;226;174;52
SINOP;22;10;1015;396;332;64
SINOP;22;10;1015;279;232;47
SINOP;22;15;1031;390;310;80
SINOP;22;16;1031;388;310;78
SINOP;22;17;1031;393;308;85
SINOP;22;24;1058;388;322;66
SINOP;22;25;1058;389;292;97
SINOP;22;26;1058;388;299;89
SINOP;22;27;1058;378;297;81
SINOP;22;28;1058;383;296;87
SINOP;22;31;1015;393;326;67
SINOP;22;31;1015;278;228;50
SINOP;22;32;1015;395;336;59
SINOP;22;32;1015;279;239;40
SINOP;22;33;1015;394;318;76
SINOP;22;33;1015;282;229;53
SINOP;22;36;1090;398;281;117
SINOP;22;37;1090;397;301;96
SINOP;22;38;1090;395;279;116
SINOP;22;73;1015;225;199;26
SINOP;22;74;1031;397;317;80
SINOP;22;75;1058;374;301;73
SINOP;22;76;1090;392;281;111
SINOP;22;77;1058;385;306;79
SINOP;22;80;1015;225;191;34
SINOP;22;81;1015;224;185;39
SINOP;22;83;1058;387;305;82
SINOP;22;84;1090;389;273;116
SINOP;22;96;1090;395;308;87
SINOP;22;97;1392;409;314;95
SINOP;22;97;1392;317;243;74
SINOP;22;107;1090;396;295;101
SINOP;22;113;1031;391;312;79
SINOP;22;115;1090;393;265;128
SINOP;22;159;1090;395;294;101
SINOP;22;172;1090;395;282;113
SINOP;22;174;1090;389;274;115
SINOP;22;179;1090;394;281;113
SINOP;22;183;1112;366;300;66
SINOP;22;186;1058;388;312;76
SINOP;22;187;1031;393;319;74
SINOP;22;188;1139;329;254;75
SINOP;22;189;1376;390;299;91
SINOP;22;190;1376;391;315;76
SINOP;22;193;1392;408;309;99
SINOP;22;193;1392;309;228;81
SINOP;22;198;1112;365;310;55
SINOP;22;199;1392;409;325;84
SINOP;22;199;1392;317;250;67
SINOP;22;200;1376;390;314;76
SINOP;22;207;1376;393;297;96
SINOP;22;213;1376;387;320;67
SINOP;22;218;1031;388;311;77
SINOP;22;222;1112;365;315;50
SINOP;22;224;1236;398;316;82
SINOP;22;228;1228;346;265;81
SINOP;22;236;1236;393;320;73
SINOP;22;237;1112;362;303;59
SINOP;22;239;1139;323;263;60
SINOP;22;240;1228;343;260;83
SINOP;22;242;1090;390;276;114
SINOP;22;253;1236;392;315;77
SINOP;22;263;1279;383;270;113
SINOP;22;264;1295;399;329;70
SINOP;22;266;1236;394;325;69
SINOP;22;269;1228;340;268;72
SINOP;22;271;1376;387;290;97
SINOP;22;287;1236;392;314;78
SINOP;22;291;1090;392;293;99
SINOP;22;292;1660;259;209;50
SINOP;22;294;1139;327;261;66
SINOP;22;295;1112;360;312;48
SINOP;22;299;1660;263;207;56
SINOP;22;301;1236;394;316;78
SINOP;22;302;1660;263;195;68
SINOP;22;313;1236;391;317;74
SINOP;22;314;1295;391;321;70
SINOP;22;316;1279;382;264;118
SINOP;22;317;1228;342;267;75
SINOP;22;319;1660;260;206;54
SINOP;22;325;1660;258;189;69
SINOP;22;330;1236;394;315;79
SINOP;22;332;1031;393;312;81
SINOP;22;335;1660;261;203;58
SINOP;22;338;1376;393;305;88
SINOP;22;342;1228;343;251;92
SINOP;22;345;1295;395;327;68
SINOP;22;353;1392;406;329;77
SINOP;22;353;1392;310;251;59
SINOP;22;355;1384;357;285;72
SINOP;22;357;1112;359;305;54
SINOP;22;359;1228;342;255;87
SINOP;22;363;1279;376;259;117
SINOP;22;364;1295;396;330;66
SINOP;22;365;1031;390;321;69
SINOP;22;367;1376;386;308;78
SINOP;22;370;1660;262;193;69
SINOP;22;372;1384;360;268;92
SINOP;22;373;1430;386;276;110
SINOP;22;374;1295;395;325;70
SINOP;22;375;1376;390;317;73
SINOP;22;376;1031;385;321;64
SINOP;22;377;1295;394;328;66
SINOP;22;378;1430;387;281;106
SINOP;22;379;1112;361;294;67
SINOP;22;380;1660;262;190;72
SINOP;22;382;1376;397;311;86
SINOP;22;383;1430;388;267;121
SINOP;22;384;1295;388;334;54
SINOP;22;385;1660;263;184;79
SINOP;22;386;1376;391;294;97
SINOP;22;387;1031;387;310;77
SINOP;22;388;1228;348;260;88
SINOP;22;389;1139;328;260;68
SINOP;22;390;1430;388;279;109
SINOP;22;391;1279;375;266;109
SINOP;22;392;1457;387;250;137
SINOP;22;393;1465;385;295;90
SINOP;22;394;1449;231;164;67
SINOP;22;395;1295;384;322;62
SINOP;22;396;1384;365;267;98
SINOP;22;397;1376;394;300;94
SINOP;22;398;1457;389;258;131
SINOP;22;399;1295;391;320;71
SINOP;22;400;1457;396;252;144
SINOP;22;401;1457;393;265;128
SINOP;22;402;1295;395;311;84
SINOP;22;403;1457;395;255;140
SINOP;22;404;1430;392;278;114
SINOP;22;405;1465;384;253;131
SINOP;22;406;1376;395;312;83
SINOP;22;407;1384;363;254;109
SINOP;22;408;1457;390;249;141
SINOP;22;409;1430;386;255;131
SINOP;22;410;1473;375;259;116
SINOP;22;411;1473;375;253;122
SINOP;22;412;1473;367;257;110
SINOP;22;413;1473;379;274;105
SINOP;22;414;1473;369;276;93
SINOP;22;415;1473;375;264;111
SINOP;22;416;1473;372;279;93
SINOP;22;417;1473;372;261;111
SINOP;22;418;1473;371;265;106
SINOP;22;419;1473;369;263;106
SINOP;22;420;1473;370;273;97
SINOP;22;421;1473;370;253;117
SINOP;22;422;1481;386;291;95
SINOP;22;423;1481;384;281;103
SINOP;22;424;1481;382;280;102
SINOP;22;425;1481;384;292;92
SINOP;22;426;1481;384;279;105
SINOP;22;427;1481;375;291;84
SINOP;22;428;1481;377;281;96
SINOP;22;429;1481;386;291;95
SINOP;22;430;1481;382;293;89
SINOP;22;431;1481;385;292;93
SINOP;22;432;1481;384;282;102
SINOP;22;433;1481;386;297;89
SINOP;22;434;1481;379;285;94
SINOP;22;435;1481;388;296;92
SINOP;22;436;1490;212;165;47
SINOP;22;437;1503;369;269;100
SINOP;22;438;1511;389;267;122
SINOP;22;439;1511;373;268;105
SINOP;22;440;1511;378;254;124
SINOP;22;441;1511;387;282;105
SINOP;22;442;1520;321;240;81
SINOP;22;443;1520;319;229;90
SINOP;22;444;1520;322;252;70
SINOP;22;445;1520;321;258;63
SINOP;22;446;1520;317;243;74
SINOP;22;447;1520;322;243;79
SINOP;22;448;1520;321;252;69
SINOP;22;449;1520;322;239;83
SINOP;22;450;1520;321;256;65
SINOP;22;451;1520;324;263;61
SINOP;22;452;1538;394;285;109
SINOP;22;453;1538;389;290;99
SINOP;22;454;1538;392;301;91
SINOP;22;455;1538;390;284;106
SINOP;22;456;1538;389;255;134
SINOP;22;457;1538;389;275;114
SINOP;22;458;1538;394;275;119
SINOP;22;459;1538;392;278;114
SINOP;22;460;1538;394;278;116
SINOP;22;461;1538;398;294;104
SINOP;22;462;1538;397;296;101
SINOP;22;463;1538;394;280;114
SINOP;22;464;1538;398;279;119
SINOP;22;465;1538;394;280;114
SINOP;22;466;1538;395;259;136
SINOP;22;467;1538;394;251;143
SINOP;22;468;1554;387;312;75
SINOP;22;469;1554;389;300;89
SINOP;22;470;1554;385;296;89
SINOP;22;471;1554;389;310;79
SINOP;22;472;1554;388;309;79
SINOP;22;473;1554;389;305;84
SINOP;22;474;1554;387;310;77
SINOP;22;475;1554;389;289;100
SINOP;22;476;1554;395;318;77
SINOP;22;477;1554;387;307;80
SINOP;22;478;1554;385;291;94
SINOP;22;479;1554;385;301;84
SINOP;22;480;1554;386;302;84
SINOP;22;481;1554;387;298;89
SINOP;22;482;1562;391;281;110
SINOP;22;483;1562;393;282;111
SINOP;22;484;1562;391;306;85
SINOP;22;485;1562;390;296;94
SINOP;22;486;1562;390;292;98
SINOP;22;487;1562;415;283;132
SINOP;22;488;1562;391;275;116
SINOP;22;489;1562;391;291;100
SINOP;22;490;1562;390;267;123
SINOP;22;491;1562;396;304;92
SINOP;22;492;1562;395;305;90
SINOP;22;493;1570;322;260;62
SINOP;22;494;1570;322;257;65
SINOP;22;495;1570;321;260;61
SINOP;22;496;1570;323;252;71
SINOP;22;497;1570;321;267;54
SINOP;22;498;1570;321;255;66
SINOP;22;499;1570;319;251;68
SINOP;22;500;1570;322;248;74
SINOP;22;501;1597;341;263;78
SINOP;22;502;1597;342;242;100
SINOP;22;503;1597;347;246;101
SINOP;22;504;1600;348;271;77
SINOP;22;505;1600;345;264;81
SINOP;22;506;1600;342;261;81
SINOP;22;507;1600;346;274;72
SINOP;22;508;1600;346;242;104
SINOP;22;509;1619;364;293;71
SINOP;22;510;1619;365;292;73
SINOP;22;511;1619;371;300;71
SINOP;22;512;1619;368;294;74
SINOP;22;513;1619;369;292;77
SINOP;22;514;1619;366;286;80
SINOP;22;515;1619;369;300;69
SINOP;22;516;1619;361;287;74
SINOP;22;517;1619;363;285;78
SINOP;22;518;1619;365;295;70
SINOP;22;519;1619;369;288;81
SINOP;22;520;1619;365;277;88
SINOP;22;521;1619;365;278;87
SINOP;22;522;1627;381;295;86
SINOP;22;523;1627;379;268;111
SINOP;22;524;1627;375;288;87
SINOP;22;525;1627;380;295;85
SINOP;22;526;1627;377;272;105
SINOP;22;527;1627;380;270;110
SINOP;22;528;1635;391;293;98
SINOP;22;529;1635;390;292;98
SINOP;22;530;1635;394;297;97
SINOP;22;531;1635;392;297;95
SINOP;22;532;1635;394;278;116
SINOP;22;533;1635;391;297;94
SINOP;22;534;1635;399;293;106
SINOP;22;535;1635;392;299;93
SINOP;22;536;1635;395;311;84
SINOP;22;537;1635;394;299;95
SINOP;22;538;1635;394;308;86
SINOP;22;539;1635;389;292;97
SINOP;22;540;1635;393;314;79
SINOP;22;541;1643;372;289;83
SINOP;22;542;1643;365;273;92
SINOP;22;543;1643;373;310;63
SINOP;22;544;1643;372;291;81
SINOP;22;545;1643;370;299;71
SINOP;22;546;1643;361;285;76
SINOP;22;547;1643;366;300;66
SINOP;22;548;1643;374;297;77
SINOP;22;549;1643;375;298;77
SINOP;22;550;1643;370;293;77
SINOP;22;551;1643;365;298;67
SINOP;22;552;1643;367;286;81
SINOP;22;553;1643;375;293;82
SINOP;22;554;1643;370;292;78
SINOP;22;555;1686;383;280;103
SINOP;22;556;1678;423;337;86
SINOP;22;557;1538;391;248;143
SINOP;22;558;1686;393;298;95
SINOP;22;559;1430;392;287;105
SINOP;22;560;1538;392;259;133
SINOP;22;561;1686;398;329;69
SINOP;22;562;1279;209;163;46
SINOP;22;563;1465;197;161;36
SINOP;22;564;1678;393;362;31
SINOP;22;565;1538;400;305;95
SINOP;22;566;1430;364;278;86
SINOP;22;567;1686;397;353;44
SINOP;22;568;1511;111;85;26
SINOP;22;569;1058;280;244;36
SINOP;22;570;1538;155;127;28
SINOP;22;571;1686;212;190;22
COLÍDER;23;1;1015;332;254;78
COLÍDER;23;2;1015;339;265;74
COLÍDER;23;3;1015;337;256;81
COLÍDER;23;4;1015;344;256;88
COLÍDER;23;5;1015;338;267;71
COLÍDER;23;6;1015;333;260;73
COLÍDER;23;7;1023;323;242;81
COLÍDER;23;8;1023;336;244;92
COLÍDER;23;9;1023;323;243;80
COLÍDER;23;10;1023;330;248;82
COLÍDER;23;11;1112;317;222;95
COLÍDER;23;12;1112;327;246;81
COLÍDER;23;13;1112;322;228;94
COLÍDER;23;14;1538;314;226;88
COLÍDER;23;15;1538;333;236;97
COLÍDER;23;16;1040;337;253;84
COLÍDER;23;17;1040;338;263;75
COLÍDER;23;18;1511;278;203;75
COLÍDER;23;19;1511;292;219;73
COLÍDER;23;20;1120;254;201;53
COLÍDER;23;21;1120;251;203;48
COLÍDER;23;22;1015;341;269;72
COLÍDER;23;23;1015;337;239;98
COLÍDER;23;24;1120;256;192;64
COLÍDER;23;25;1120;262;207;55
COLÍDER;23;26;1015;341;242;99
COLÍDER;23;27;1112;330;252;78
COLÍDER;23;28;1112;336;251;85
COLÍDER;23;29;1120;258;205;53
COLÍDER;23;30;1120;265;203;62
COLÍDER;23;31;1139;369;263;106
COLÍDER;23;33;1139;175;138;37
COLÍDER;23;34;1147;328;232;96
COLÍDER;23;37;1147;219;160;59
COLÍDER;23;39;1155;305;207;98
COLÍDER;23;42;1163;290;202;88
COLÍDER;23;43;1171;287;192;95
COLÍDER;23;45;1171;273;190;83
COLÍDER;23;47;1538;278;202;76
NOVA SANTA HELENA;23;70;1031;296;230;66
NOVA SANTA HELENA;23;71;1023;317;252;65
NOVA SANTA HELENA;23;72;1023;302;232;70
ITAÚBA;23;73;1031;408;278;130
ITAÚBA;23;75;1031;399;274;125
ITAÚBA;23;77;1031;392;282;110
NOVA CANAÃ DO NORTE;23;102;1015;230;157;73
NOVA CANAÃ DO NORTE;23;103;1015;232;167;65
NOVA CANAÃ DO NORTE;23;104;1015;231;155;76
NOVA CANAÃ DO NORTE;23;105;1015;230;175;55
NOVA CANAÃ DO NORTE;23;106;1015;231;175;56
NOVA CANAÃ DO NORTE;23;107;1015;228;158;70
NOVA CANAÃ DO NORTE;23;108;1015;230;155;75
NOVA CANAÃ DO NORTE;23;109;1015;229;174;55
NOVA CANAÃ DO NORTE;23;110;1040;364;270;94
NOVA CANAÃ DO NORTE;23;111;1015;230;162;68
NOVA CANAÃ DO NORTE;23;112;1015;230;166;64
NOVA CANAÃ DO NORTE;23;113;1040;359;271;88
NOVA CANAÃ DO NORTE;23;114;1040;356;253;103
NOVA CANAÃ DO NORTE;23;115;1040;353;250;103
NOVA CANAÃ DO NORTE;23;116;1040;362;252;110
NOVA CANAÃ DO NORTE;23;149;1074;397;267;130
NOVA SANTA HELENA;23;150;1023;312;260;52
NOVA CANAÃ DO NORTE;23;151;1015;228;164;64
COLÍDER;23;157;1023;315;245;70
NOVA CANAÃ DO NORTE;23;159;1015;227;173;54
NOVA CANAÃ DO NORTE;23;160;1040;231;178;53
NOVA CANAÃ DO NORTE;23;162;1074;216;161;55
NOVA CANAÃ DO NORTE;23;163;1040;229;181;48
NOVA SANTA HELENA;23;173;1023;316;245;71
NOVA CANAÃ DO NORTE;23;175;1040;230;176;54
NOVA CANAÃ DO NORTE;23;176;1040;357;256;101
COLÍDER;23;195;1481;338;257;81
ITAÚBA;23;203;1031;409;304;105
NOVA SANTA HELENA;23;204;1031;301;248;53
COLÍDER;23;211;1015;330;281;49
COLÍDER;23;212;1040;346;276;70
COLÍDER;23;213;1015;333;264;69
COLÍDER;23;214;1015;324;255;69
NOVA CANAÃ DO NORTE;23;227;1090;327;254;73
NOVA CANAÃ DO NORTE;23;232;1074;205;141;64
COLÍDER;23;237;1481;334;251;83
COLÍDER;23;241;1481;324;250;74
NOVA CANAÃ DO NORTE;23;243;1090;321;229;92
COLÍDER;23;244;1023;322;247;75
COLÍDER;23;245;1015;324;266;58
NOVA CANAÃ DO NORTE;23;250;1074;202;135;67
NOVA SANTA HELENA;23;267;1040;214;166;48
NOVA CANAÃ DO NORTE;23;275;1074;202;144;58
ITAÚBA;23;278;1031;390;276;114
ITAÚBA;23;278;1031;389;275;114
NOVA CANAÃ DO NORTE;23;279;1090;326;234;92
COLÍDER;23;280;1511;281;197;84
COLÍDER;23;281;1481;331;249;82
NOVA SANTA HELENA;23;282;1031;287;222;65
NOVA CANAÃ DO NORTE;23;283;1112;269;210;59
COLÍDER;23;284;1112;337;276;61
ITAÚBA;23;288;1058;308;208;100
COLÍDER;23;291;1511;283;203;80
COLÍDER;23;292;1481;313;229;84
NOVA CANAÃ DO NORTE;23;294;1112;268;204;64
ITAÚBA;23;296;1058;305;218;87
ITAÚBA;23;300;1058;300;212;88
NOVA SANTA HELENA;23;301;1031;292;230;62
COLÍDER;23;302;1481;338;267;71
COLÍDER;23;303;1511;273;201;72
ITAÚBA;23;304;1058;309;211;98
COLÍDER;23;305;1040;356;270;86
COLÍDER;23;306;1023;337;259;78
COLÍDER;23;307;1112;332;255;77
COLÍDER;23;308;1481;317;235;82
ITAÚBA;23;309;1058;317;201;116
COLÍDER;23;310;1481;327;245;82
COLÍDER;23;311;1538;322;217;105
NOVA CANAÃ DO NORTE;23;312;1090;327;253;74
NOVA CANAÃ DO NORTE;23;313;1040;351;235;116
COLÍDER;23;314;1023;330;237;93
ITAÚBA;23;315;1058;325;205;120
COLÍDER;23;317;1015;326;240;86
NOVA CANAÃ DO NORTE;23;318;1112;268;200;68
COLÍDER;23;319;1023;327;249;78
COLÍDER;23;320;1511;291;199;92
COLÍDER;23;321;1023;324;233;91
NOVA CANAÃ DO NORTE;23;322;1040;352;237;115
COLÍDER;23;323;1511;290;189;101
COLÍDER;23;326;1511;292;200;92
NOVA SANTA HELENA;23;327;1031;292;186;106
COLÍDER;23;328;1511;269;182;87
NOVA CANAÃ DO NORTE;23;329;1040;356;229;127
COLÍDER;23;330;1538;260;203;57
COLÍDER;23;331;1511;269;194;75
COLÍDER;23;332;1511;273;190;83
COLÍDER;23;333;1040;310;224;86
COLÍDER;23;334;1112;301;247;54
COLÍDER;23;335;1481;248;188;60
ITAÚBA;23;336;1058;369;306;63
COLÍDER;23;337;1546;201;178;23
COLÍDER;23;338;1554;313;276;37
ALTA FLORESTA;24;2;1015;323;229;94
ALTA FLORESTA;24;4;1015;323;231;92
ALTA FLORESTA;24;8;1015;173;117;56
ALTA FLORESTA;24;12;1023;206;166;40
ALTA FLORESTA;24;14;1023;393;301;92
ALTA FLORESTA;24;17;1023;391;286;105
ALTA FLORESTA;24;18;1368;384;278;106
ALTA FLORESTA;24;19;1368;389;272;117
ALTA FLORESTA;24;20;1368;393;277;116
ALTA FLORESTA;24;21;1368;383;277;106
ALTA FLORESTA;24;22;1368;382;257;125
ALTA FLORESTA;24;26;1392;352;271;81
ALTA FLORESTA;24;27;1392;352;276;76
ALTA FLORESTA;24;28;1392;181;136;45
ALTA FLORESTA;24;29;1392;350;273;77
ALTA FLORESTA;24;30;1031;298;231;67
ALTA FLORESTA;24;32;1031;299;217;82
ALTA FLORESTA;24;33;1031;302;216;86
ALTA FLORESTA;24;35;1031;159;106;53
ALTA FLORESTA;24;36;1031;305;228;77
ALTA FLORESTA;24;39;1031;304;227;77
ALTA FLORESTA;24;40;1040;285;224;61
ALTA FLORESTA;24;41;1040;296;214;82
ALTA FLORESTA;24;42;1040;291;219;72
ALTA FLORESTA;24;43;1040;284;218;66
ALTA FLORESTA;24;44;1040;291;205;86
ALTA FLORESTA;24;45;1040;290;216;74
ALTA FLORESTA;24;46;1040;280;206;74
ALTA FLORESTA;24;47;1040;282;215;67
ALTA FLORESTA;24;48;1040;288;200;88
ALTA FLORESTA;24;49;1040;297;208;89
ALTA FLORESTA;24;51;1023;394;290;104
ALTA FLORESTA;24;55;1023;395;294;101
PARANAÍTA;24;57;1015;250;191;59
PARANAÍTA;24;59;1015;247;190;57
PARANAÍTA;24;61;1015;256;202;54
PARANAÍTA;24;63;1015;257;185;72
PARANAÍTA;24;65;1023;314;225;89
PARANAÍTA;24;67;1023;311;234;77
PARANAÍTA;24;69;1023;305;240;65
PARANAÍTA;24;71;1023;302;218;84
CARLINDA;24;85;1015;319;240;79
CARLINDA;24;85;1015;318;239;79
CARLINDA;24;86;1015;322;242;80
CARLINDA;24;87;1015;322;249;73
CARLINDA;24;88;1015;317;226;91
CARLINDA;24;89;1015;318;234;84
ALTA FLORESTA;24;92;1406;417;310;107
ALTA FLORESTA;24;96;1406;417;310;107
ALTA FLORESTA;24;97;1155;296;210;86
ALTA FLORESTA;24;103;1023;395;303;92
ALTA FLORESTA;24;107;1023;393;301;92
ALTA FLORESTA;24;109;1023;197;161;36
CARLINDA;24;112;1015;317;229;88
PARANAÍTA;24;114;1015;245;195;50
ALTA FLORESTA;24;115;1074;404;281;123
ALTA FLORESTA;24;119;1171;314;236;78
ALTA FLORESTA;24;122;1023;394;302;92
CARLINDA;24;126;1015;320;231;89
CARLINDA;24;127;1015;319;240;79
PARANAÍTA;24;129;1015;252;194;58
PARANAÍTA;24;131;1023;299;224;75
PARANAÍTA;24;133;1023;307;240;67
PARANAÍTA;24;135;1023;310;234;76
PARANAÍTA;24;137;1015;257;200;57
PARANAÍTA;24;138;1015;247;187;60
ALTA FLORESTA;24;139;1074;404;291;113
ALTA FLORESTA;24;140;1406;409;312;97
ALTA FLORESTA;24;141;1090;310;233;77
ALTA FLORESTA;24;143;1090;307;235;72
CARLINDA;24;144;1015;321;253;68
ALTA FLORESTA;24;147;1074;406;305;101
ALTA FLORESTA;24;149;1040;287;222;65
ALTA FLORESTA;24;150;1074;397;301;96
CARLINDA;24;152;1074;324;251;73
ALTA FLORESTA;24;153;1155;292;201;91
ALTA FLORESTA;24;158;1074;413;287;126
ALTA FLORESTA;24;159;1406;415;306;109
ALTA FLORESTA;24;160;1090;308;239;69
CARLINDA;24;161;1074;323;237;86
CARLINDA;24;162;1023;241;187;54
ALTA FLORESTA;24;163;1074;412;289;123
ALTA FLORESTA;24;164;1104;374;251;123
ALTA FLORESTA;24;165;1139;337;259;78
ALTA FLORESTA;24;166;1171;313;250;63
CARLINDA;24;171;1074;324;237;87
ALTA FLORESTA;24;172;1074;404;302;102
ALTA FLORESTA;24;173;1090;302;230;72
CARLINDA;24;174;1074;322;225;97
CARLINDA;24;175;1074;321;242;79
ALTA FLORESTA;24;177;1163;418;318;100
ALTA FLORESTA;24;178;1180;396;277;119
CARLINDA;24;179;1031;207;147;60
CARLINDA;24;180;1040;236;172;64
ALTA FLORESTA;24;181;1244;281;221;60
ALTA FLORESTA;24;185;1260;324;228;96
CARLINDA;24;187;1023;239;173;66
CARLINDA;24;188;1058;275;209;66
ALTA FLORESTA;24;190;1074;401;297;104
ALTA FLORESTA;24;191;1104;369;254;115
ALTA FLORESTA;24;192;1279;413;305;108
ALTA FLORESTA;24;193;1287;377;274;103
ALTA FLORESTA;24;194;1295;397;300;97
ALTA FLORESTA;24;195;1309;417;305;112
ALTA FLORESTA;24;196;1317;344;253;91
CARLINDA;24;197;1031;206;156;50
CARLINDA;24;198;1023;239;187;52
ALTA FLORESTA;24;199;1325;165;127;38
ALTA FLORESTA;24;200;1333;283;209;74
CARLINDA;24;202;1040;232;168;64
CARLINDA;24;203;1066;237;175;62
ALTA FLORESTA;24;205;1287;370;276;94
ALTA FLORESTA;24;206;1180;385;284;101
ALTA FLORESTA;24;208;1287;371;282;89
ALTA FLORESTA;24;209;1090;307;238;69
ALTA FLORESTA;24;210;1163;422;325;97
CARLINDA;24;211;1074;324;233;91
ALTA FLORESTA;24;214;1287;374;261;113
ALTA FLORESTA;24;215;1104;369;260;109
PARANAÍTA;24;216;1058;366;258;108
PARANAÍTA;24;218;1040;356;277;79
ALTA FLORESTA;24;219;1287;366;280;86
PARANAÍTA;24;220;1058;374;260;114
PARANAÍTA;24;221;1040;383;297;86
ALTA FLORESTA;24;223;1317;341;250;91
CARLINDA;24;225;1058;275;213;62
ALTA FLORESTA;24;226;1287;378;287;91
ALTA FLORESTA;24;228;1180;395;271;124
ALTA FLORESTA;24;230;1295;395;275;120
PARANAÍTA;24;231;1040;371;278;93
CARLINDA;24;232;1074;324;244;80
ALTA FLORESTA;24;234;1287;375;281;94
ALTA FLORESTA;24;235;1309;408;302;106
ALTA FLORESTA;24;237;1350;200;146;54
PARANAÍTA;24;238;1040;381;283;98
CARLINDA;24;239;1074;324;237;87
PARANAÍTA;24;241;1040;363;276;87
ALTA FLORESTA;24;244;1279;407;314;93
ALTA FLORESTA;24;245;1163;428;325;103
ALTA FLORESTA;24;246;1376;376;291;85
PARANAÍTA;24;247;1082;323;247;76
ALTA FLORESTA;24;254;1287;372;275;97
ALTA FLORESTA;24;255;1104;366;253;113
ALTA FLORESTA;24;256;1317;344;260;84
PARANAÍTA;24;257;1082;328;245;83
ALTA FLORESTA;24;264;1180;397;281;116
ALTA FLORESTA;24;265;1287;385;290;95
ALTA FLORESTA;24;267;1090;319;236;83
ALTA FLORESTA;24;268;1163;419;329;90
ALTA FLORESTA;24;269;1376;377;269;108
ALTA FLORESTA;24;271;1287;380;278;102
PARANAÍTA;24;272;1082;337;243;94
ALTA FLORESTA;24;273;1279;394;296;98
ALTA FLORESTA;24;274;1180;392;273;119
ALTA FLORESTA;24;275;1104;377;244;133
ALTA FLORESTA;24;276;1295;382;285;97
ALTA FLORESTA;24;277;1309;402;299;103
ALTA FLORESTA;24;278;1074;410;297;113
ALTA FLORESTA;24;279;1317;349;271;78
ALTA FLORESTA;24;280;1163;419;308;111
ALTA FLORESTA;24;281;1376;378;283;95
ALTA FLORESTA;24;282;1180;364;263;101
PARANAÍTA;24;283;1040;387;273;114
PARANAÍTA;24;284;1082;326;244;82
ALTA FLORESTA;24;285;1406;393;306;87
ALTA FLORESTA;24;286;1279;378;323;55
ALTA FLORESTA;24;287;1163;392;323;69
ALTA FLORESTA;24;288;1376;350;259;91
ALTA FLORESTA;24;289;1104;342;251;91
ALTA FLORESTA;24;290;1180;358;262;96
ALTA FLORESTA;24;291;1287;350;262;88
ALTA FLORESTA;24;292;1406;394;285;109
ALTA FLORESTA;24;293;1317;316;244;72
PARANAÍTA;24;294;1040;381;291;90
PARANAÍTA;24;295;1040;347;255;92
ALTA FLORESTA;24;296;1406;72;58;14
PONTES E LACERDA;25;36;1015;291;225;66
PONTES E LACERDA;25;37;1015;289;219;70
PONTES E LACERDA;25;38;1015;294;217;77
PONTES E LACERDA;25;39;1015;289;214;75
PONTES E LACERDA;25;40;1015;294;225;69
PONTES E LACERDA;25;41;1015;286;222;64
PONTES E LACERDA;25;42;1015;289;213;76
PONTES E LACERDA;25;43;1015;288;211;77
PONTES E LACERDA;25;44;1015;286;216;70
PONTES E LACERDA;25;45;1015;292;225;67
PONTES E LACERDA;25;46;1015;285;203;82
PONTES E LACERDA;25;47;1015;292;218;74
PONTES E LACERDA;25;48;1023;283;210;73
PONTES E LACERDA;25;49;1023;282;204;78
PONTES E LACERDA;25;50;1023;281;206;75
PONTES E LACERDA;25;51;1023;282;198;84
PONTES E LACERDA;25;52;1023;285;213;72
PONTES E LACERDA;25;53;1023;282;184;98
PONTES E LACERDA;25;54;1023;281;192;89
PONTES E LACERDA;25;55;1031;292;214;78
PONTES E LACERDA;25;56;1031;288;209;79
PONTES E LACERDA;25;57;1031;292;188;104
PONTES E LACERDA;25;58;1031;290;203;87
PONTES E LACERDA;25;59;1031;291;216;75
PONTES E LACERDA;25;60;1031;294;206;88
PONTES E LACERDA;25;61;1163;295;202;93
PONTES E LACERDA;25;62;1031;295;226;69
PONTES E LACERDA;25;63;1023;286;209;77
PONTES E LACERDA;25;65;1082;240;173;67
PONTES E LACERDA;25;66;1082;241;174;67
PONTES E LACERDA;25;67;1082;247;187;60
PONTES E LACERDA;25;68;1090;394;279;115
VALE DE SÃO DOMINGOS;25;70;1040;275;209;66
VALE DE SÃO DOMINGOS;25;71;1040;274;203;71
VALE DE SÃO DOMINGOS;25;72;1023;382;273;109
PONTES E LACERDA;25;75;1120;276;198;78
PONTES E LACERDA;25;77;1031;285;212;73
VILA BELA DA SANTÍSSIMA TRINDADE;25;80;1015;250;180;70
VILA BELA DA SANTÍSSIMA TRINDADE;25;81;1015;244;166;78
VILA BELA DA SANTÍSSIMA TRINDADE;25;82;1031;222;144;78
VILA BELA DA SANTÍSSIMA TRINDADE;25;84;1031;218;150;68
VILA BELA DA SANTÍSSIMA TRINDADE;25;85;1368;350;246;104
VILA BELA DA SANTÍSSIMA TRINDADE;25;100;1171;271;194;77
PONTES E LACERDA;25;102;1120;139;93;46
PONTES E LACERDA;25;103;1350;337;268;69
VALE DE SÃO DOMINGOS;25;104;1015;215;153;62
PONTES E LACERDA;25;107;1023;283;196;87
PONTES E LACERDA;25;108;1023;283;208;75
PONTES E LACERDA;25;109;1023;277;198;79
PONTES E LACERDA;25;122;1163;295;226;69
PONTES E LACERDA;25;123;1163;288;210;78
PONTES E LACERDA;25;124;1031;287;205;82
PONTES E LACERDA;25;125;1350;336;285;51
PONTES E LACERDA;25;126;1120;276;205;71
VILA BELA DA SANTÍSSIMA TRINDADE;25;127;1066;218;174;44
VILA BELA DA SANTÍSSIMA TRINDADE;25;131;1015;248;188;60
PONTES E LACERDA;25;133;1023;285;203;82
VILA BELA DA SANTÍSSIMA TRINDADE;25;136;1333;204;162;42
PONTES E LACERDA;25;138;1147;180;149;31
PONTES E LACERDA;25;139;1023;281;210;71
PONTES E LACERDA;25;141;1023;278;224;54
VILA BELA DA SANTÍSSIMA TRINDADE;25;142;1015;250;189;61
VILA BELA DA SANTÍSSIMA TRINDADE;25;143;1368;368;249;119
PONTES E LACERDA;25;148;1163;288;207;81
PONTES E LACERDA;25;149;1198;261;181;80
VILA BELA DA SANTÍSSIMA TRINDADE;25;154;1201;288;206;82
PONTES E LACERDA;25;157;1163;289;217;72
VILA BELA DA SANTÍSSIMA TRINDADE;25;159;1015;244;172;72
VILA BELA DA SANTÍSSIMA TRINDADE;25;160;1120;185;129;56
VILA BELA DA SANTÍSSIMA TRINDADE;25;161;1120;366;251;115
VILA BELA DA SANTÍSSIMA TRINDADE;25;162;1015;247;185;62
VALE DE SÃO DOMINGOS;25;167;1015;211;142;69
PONTES E LACERDA;25;168;1163;294;205;89
PONTES E LACERDA;25;169;1198;262;190;72
VILA BELA DA SANTÍSSIMA TRINDADE;25;171;1252;235;195;40
VILA BELA DA SANTÍSSIMA TRINDADE;25;172;1252;234;184;50
VILA BELA DA SANTÍSSIMA TRINDADE;25;173;1252;301;207;94
PONTES E LACERDA;25;174;1023;283;206;77
PONTES E LACERDA;25;175;1163;292;206;86
PONTES E LACERDA;25;176;1198;266;192;74
PONTES E LACERDA;25;178;1198;261;198;63
PONTES E LACERDA;25;183;1023;284;216;68
PONTES E LACERDA;25;186;1163;344;252;92
PONTES E LACERDA;25;187;1198;261;178;83
VILA BELA DA SANTÍSSIMA TRINDADE;25;190;1252;294;212;82
PONTES E LACERDA;25;193;1163;292;206;86
VILA BELA DA SANTÍSSIMA TRINDADE;25;195;1333;203;149;54
VILA BELA DA SANTÍSSIMA TRINDADE;25;198;1090;377;284;93
VILA BELA DA SANTÍSSIMA TRINDADE;25;201;1104;206;165;41
VILA BELA DA SANTÍSSIMA TRINDADE;25;202;1112;339;264;75
PONTES E LACERDA;25;205;1198;259;191;68
VALE DE SÃO DOMINGOS;25;207;1015;214;153;61
PONTES E LACERDA;25;209;1090;388;290;98
PONTES E LACERDA;25;210;1163;286;208;78
VILA BELA DA SANTÍSSIMA TRINDADE;25;212;1090;373;283;90
PONTES E LACERDA;25;218;1201;274;225;49
VILA BELA DA SANTÍSSIMA TRINDADE;25;220;1015;247;194;53
VILA BELA DA SANTÍSSIMA TRINDADE;25;221;1090;376;270;106
PONTES E LACERDA;25;222;1201;265;196;69
VALE DE SÃO DOMINGOS;25;223;1015;212;162;50
PONTES E LACERDA;25;224;1023;279;198;81
VILA BELA DA SANTÍSSIMA TRINDADE;25;225;1090;377;268;109
VILA BELA DA SANTÍSSIMA TRINDADE;25;227;1015;243;176;67
PONTES E LACERDA;25;228;1201;263;197;66
PONTES E LACERDA;25;230;1201;266;199;67
VALE DE SÃO DOMINGOS;25;231;1031;291;236;55
VILA BELA DA SANTÍSSIMA TRINDADE;25;232;1279;187;139;48
VILA BELA DA SANTÍSSIMA TRINDADE;25;233;1295;252;178;74
PONTES E LACERDA;25;234;1210;241;173;68
PONTES E LACERDA;25;235;1228;257;196;61
PONTES E LACERDA;25;235;1228;256;196;60
VILA BELA DA SANTÍSSIMA TRINDADE;25;236;1287;331;251;80
PONTES E LACERDA;25;237;1228;247;187;60
PONTES E LACERDA;25;238;1210;237;167;70
PONTES E LACERDA;25;239;1201;269;194;75
PONTES E LACERDA;25;240;1015;294;211;83
VILA BELA DA SANTÍSSIMA TRINDADE;25;241;1090;375;265;110
VILA BELA DA SANTÍSSIMA TRINDADE;25;245;1295;244;158;86
PONTES E LACERDA;25;247;1198;258;187;71
VALE DE SÃO DOMINGOS;25;249;1031;290;209;81
PONTES E LACERDA;25;254;1260;228;171;57
PONTES E LACERDA;25;255;1252;390;290;100
VILA BELA DA SANTÍSSIMA TRINDADE;25;256;1309;186;156;30
PONTES E LACERDA;25;257;1244;221;168;53
VILA BELA DA SANTÍSSIMA TRINDADE;25;258;1317;273;227;46
PONTES E LACERDA;25;260;1201;271;203;68
PONTES E LACERDA;25;261;1082;242;179;63
PONTES E LACERDA;25;262;1252;386;249;137
PONTES E LACERDA;25;263;1252;384;244;140
PONTES E LACERDA;25;264;1295;83;56;27
PONTES E LACERDA;25;266;1252;389;261;128
PONTES E LACERDA;25;267;1260;227;176;51
PONTES E LACERDA;25;268;1244;236;160;76
VILA BELA DA SANTÍSSIMA TRINDADE;25;270;1171;271;198;73
PONTES E LACERDA;25;271;1082;246;183;63
PONTES E LACERDA;25;272;1252;386;264;122
PONTES E LACERDA;25;273;1082;243;165;78
PONTES E LACERDA;25;274;1201;274;202;72
PONTES E LACERDA;25;275;1031;293;189;104
PONTES E LACERDA;25;276;1260;228;164;64
PONTES E LACERDA;25;278;1317;372;275;97
PONTES E LACERDA;25;279;1309;262;192;70
VILA BELA DA SANTÍSSIMA TRINDADE;25;280;1341;336;219;117
VALE DE SÃO DOMINGOS;25;281;1031;289;200;89
PONTES E LACERDA;25;282;1317;243;181;62
PONTES E LACERDA;25;283;1309;252;180;72
PONTES E LACERDA;25;284;1201;266;190;76
PONTES E LACERDA;25;285;1244;255;190;65
PONTES E LACERDA;25;286;1317;248;187;61
PONTES E LACERDA;25;287;1309;301;217;84
PONTES E LACERDA;25;288;1201;308;228;80
PONTES E LACERDA;25;289;1317;307;241;66
PONTES E LACERDA;25;290;1260;303;211;92
PONTES E LACERDA;25;291;1252;388;260;128
PONTES E LACERDA;25;292;1317;306;200;106
PONTES E LACERDA;25;293;1244;216;141;75
PONTES E LACERDA;25;294;1201;298;215;83
PONTES E LACERDA;25;295;1309;260;168;92
PONTES E LACERDA;25;296;1260;195;129;66
PONTES E LACERDA;25;298;1163;296;186;110
PONTES E LACERDA;25;299;1163;299;242;57
VILA BELA DA SANTÍSSIMA TRINDADE;25;301;1350;88;82;6
PONTES E LACERDA;25;302;1341;224;199;25
PONTES E LACERDA;25;303;1015;287;228;59
PONTES E LACERDA;25;304;1252;206;167;39
NOVA XAVANTINA;26;22;1015;382;269;113
NOVA XAVANTINA;26;26;1015;383;261;122
NOVA XAVANTINA;26;30;1236;368;250;118
NOVA XAVANTINA;26;33;1236;363;248;115
NOVA XAVANTINA;26;35;1236;389;253;136
NOVA XAVANTINA;26;36;1236;367;268;99
NOVA XAVANTINA;26;37;1031;420;312;108
NOVA XAVANTINA;26;38;1031;417;290;127
NOVA XAVANTINA;26;39;1031;420;295;125
NOVA XAVANTINA;26;40;1031;427;277;150
NOVA XAVANTINA;26;41;1244;240;179;61
NOVA XAVANTINA;26;42;1244;235;188;47
NOVA XAVANTINA;26;44;1015;382;261;121
NOVA XAVANTINA;26;46;1015;341;231;110
NOVA XAVANTINA;26;47;1015;189;135;54
NOVA XAVANTINA;26;49;1082;392;266;126
NOVA XAVANTINA;26;50;1082;381;265;116
NOVA XAVANTINA;26;51;1082;389;264;125
NOVA XAVANTINA;26;52;1082;384;272;112
NOVA XAVANTINA;26;53;1082;385;287;98
NOVA XAVANTINA;26;54;1244;251;164;87
NOVA XAVANTINA;26;55;1104;399;259;140
NOVA XAVANTINA;26;56;1104;395;274;121
NOVA XAVANTINA;26;57;1104;400;275;125
NOVA XAVANTINA;26;58;1104;393;281;112
NOVA XAVANTINA;26;59;1104;393;291;102
NOVA XAVANTINA;26;60;1104;384;288;96
NOVA XAVANTINA;26;61;1104;390;265;125
NOVA XAVANTINA;26;63;1244;240;177;63
CAMPINÁPOLIS;26;65;1015;330;224;106
CAMPINÁPOLIS;26;67;1015;332;232;100
CAMPINÁPOLIS;26;69;1015;329;232;97
CAMPINÁPOLIS;26;70;1015;334;234;100
CAMPINÁPOLIS;26;75;1058;297;199;98
CAMPINÁPOLIS;26;76;1058;296;215;81
CAMPINÁPOLIS;26;80;1058;297;202;95
CAMPINÁPOLIS;26;83;1058;300;215;85
CAMPINÁPOLIS;26;84;1058;298;230;68
CAMPINÁPOLIS;26;85;1058;297;205;92
CAMPINÁPOLIS;26;86;1058;299;215;84
CAMPINÁPOLIS;26;87;1058;295;207;88
CAMPINÁPOLIS;26;89;1031;299;201;98
CAMPINÁPOLIS;26;91;1031;296;199;97
CAMPINÁPOLIS;26;94;1015;331;217;114
CAMPINÁPOLIS;26;96;1031;299;222;77
CAMPINÁPOLIS;26;97;1031;300;219;81
CAMPINÁPOLIS;26;98;1031;297;197;100
CAMPINÁPOLIS;26;99;1031;298;225;73
CAMPINÁPOLIS;26;100;1031;298;222;76
NOVA XAVANTINA;26;145;1163;254;199;55
NOVA XAVANTINA;26;147;1244;225;159;66
CAMPINÁPOLIS;26;152;1074;368;267;101
NOVA XAVANTINA;26;153;1082;382;267;115
CAMPINÁPOLIS;26;154;1074;370;276;94
NOVA XAVANTINA;26;155;1244;237;170;67
NOVA XAVANTINA;26;156;1244;237;175;62
CAMPINÁPOLIS;26;157;1104;408;312;96
CAMPINÁPOLIS;26;158;1112;346;250;96
CAMPINÁPOLIS;26;159;1090;354;275;79
CAMPINÁPOLIS;26;160;1015;330;241;89
NOVA XAVANTINA;26;162;1163;413;299;114
NOVA XAVANTINA;26;163;1015;353;226;127
NOVO SÃO JOAQUIM;26;164;1015;320;225;95
NOVO SÃO JOAQUIM;26;165;1015;322;251;71
NOVO SÃO JOAQUIM;26;165;1015;320;249;71
NOVO SÃO JOAQUIM;26;166;1015;318;230;88
NOVO SÃO JOAQUIM;26;167;1015;319;248;71
NOVO SÃO JOAQUIM;26;168;1015;319;234;85
NOVO SÃO JOAQUIM;26;169;1015;316;247;69
NOVO SÃO JOAQUIM;26;170;1015;320;238;82
NOVO SÃO JOAQUIM;26;171;1015;321;226;95
NOVO SÃO JOAQUIM;26;172;1015;318;232;86
NOVO SÃO JOAQUIM;26;173;1015;316;224;92
NOVO SÃO JOAQUIM;26;174;1015;321;227;94
NOVO SÃO JOAQUIM;26;175;1015;321;238;83
NOVO SÃO JOAQUIM;26;176;1015;318;245;73
NOVO SÃO JOAQUIM;26;177;1015;320;231;89
NOVO SÃO JOAQUIM;26;178;1023;214;140;74
NOVO SÃO JOAQUIM;26;181;1031;384;259;125
NOVO SÃO JOAQUIM;26;185;1040;263;212;51
NOVA XAVANTINA;26;187;1031;429;306;123
NOVA XAVANTINA;26;188;1244;240;172;68
CAMPINÁPOLIS;26;189;1112;342;252;90
CAMPINÁPOLIS;26;190;1015;322;242;80
CAMPINÁPOLIS;26;190;1015;320;240;80
CAMPINÁPOLIS;26;191;1015;330;234;96
NOVA XAVANTINA;26;192;1082;371;244;127
NOVA XAVANTINA;26;193;1082;385;258;127
NOVA XAVANTINA;26;194;1104;406;264;142
NOVA XAVANTINA;26;195;1244;239;167;72
NOVA XAVANTINA;26;196;1236;407;276;131
CAMPINÁPOLIS;26;197;1120;278;241;37
CAMPINÁPOLIS;26;198;1139;293;233;60
CAMPINÁPOLIS;26;199;1090;349;283;66
NOVA XAVANTINA;26;200;1031;429;273;156
NOVA XAVANTINA;26;201;1082;390;265;125
NOVA XAVANTINA;26;202;1236;392;264;128
JUARA;27;1;1015;237;170;67
JUARA;27;2;1015;337;244;93
JUARA;27;3;1015;238;169;69
JUARA;27;4;1015;238;173;65
JUARA;27;5;1015;233;160;73
JUARA;27;6;1015;233;171;62
JUARA;27;7;1015;233;176;57
JUARA;27;8;1015;362;244;118
JUARA;27;10;1023;366;261;105
JUARA;27;11;1023;368;266;102
JUARA;27;12;1023;366;260;106
JUARA;27;12;1023;364;258;106
JUARA;27;13;1023;368;274;94
JUARA;27;14;1023;368;269;99
JUARA;27;15;1023;364;274;90
JUARA;27;16;1023;361;260;101
JUARA;27;17;1023;362;254;108
JUARA;27;18;1031;287;215;72
JUARA;27;19;1031;286;222;64
JUARA;27;20;1031;294;229;65
JUARA;27;21;1031;291;221;70
JUARA;27;22;1031;291;216;75
JUARA;27;23;1031;295;213;82
JUARA;27;24;1031;291;226;65
JUARA;27;25;1031;289;241;48
JUARA;27;26;1031;289;217;72
JUARA;27;27;1031;289;222;67
JUARA;27;28;1040;362;253;109
JUARA;27;29;1040;357;252;105
JUARA;27;30;1040;358;242;116
JUARA;27;31;1040;358;250;108
JUARA;27;32;1040;352;233;119
JUARA;27;33;1040;355;248;107
JUARA;27;35;1163;390;295;95
JUARA;27;35;1163;389;294;95
JUARA;27;36;1163;396;287;109
JUARA;27;38;1210;324;251;73
JUARA;27;39;1210;322;235;87
JUARA;27;40;1066;222;150;72
JUARA;27;41;1066;225;160;65
JUARA;27;44;1040;366;275;91
JUARA;27;45;1104;268;180;88
JUARA;27;47;1260;229;133;96
JUARA;27;48;1228;387;281;106
JUARA;27;50;1147;356;243;113
JUARA;27;53;1210;326;244;82
JUARA;27;56;1155;374;261;113
JUARA;27;57;1163;325;256;69
JUARA;27;58;1198;145;93;52
JUARA;27;61;1155;375;253;122
JUARA;27;62;1163;316;255;61
JUARA;27;63;1163;325;241;84
JUARA;27;64;1155;368;249;119
JUARA;27;65;1155;375;260;115
JUARA;27;66;1163;316;249;67
JUARA;27;67;1295;322;260;62
JUARA;27;68;1155;369;254;115
JUARA;27;69;1295;373;291;82
JUARA;27;70;1147;178;122;56
JUARA;27;71;1228;382;270;112
JUARA;27;72;1155;374;256;118
JUARA;27;73;1295;311;231;80
JUARA;27;74;1210;318;229;89
JUARA;27;75;1252;280;204;76
JUARA;27;76;1210;325;252;73
JUARA;27;77;1210;317;240;77
PORTO DOS GAÚCHOS;27;79;1015;357;267;90
PORTO DOS GAÚCHOS;27;80;1015;355;259;96
PORTO DOS GAÚCHOS;27;81;1015;352;268;84
PORTO DOS GAÚCHOS;27;82;1015;351;279;72
PORTO DOS GAÚCHOS;27;82;1015;350;278;72
PORTO DOS GAÚCHOS;27;83;1040;329;271;58
PORTO DOS GAÚCHOS;27;84;1040;337;268;69
PORTO DOS GAÚCHOS;27;85;1040;331;262;69
PORTO DOS GAÚCHOS;27;86;1040;332;255;77
PORTO DOS GAÚCHOS;27;87;1023;381;275;106
PORTO DOS GAÚCHOS;27;90;1031;262;182;80
PORTO DOS GAÚCHOS;27;91;1031;262;190;72
TABAPORÃ;27;92;1015;360;246;114
TABAPORÃ;27;93;1015;361;266;95
TABAPORÃ;27;94;1015;363;265;98
TABAPORÃ;27;95;1015;359;261;98
TABAPORÃ;27;96;1015;364;282;82
TABAPORÃ;27;97;1015;361;254;107
TABAPORÃ;27;98;1015;361;242;119
TABAPORÃ;27;99;1023;377;273;104
TABAPORÃ;27;100;1023;375;280;95
TABAPORÃ;27;101;1023;372;276;96
TABAPORÃ;27;102;1031;314;229;85
TABAPORÃ;27;103;1040;340;245;95
TABAPORÃ;27;104;1040;337;257;80
TABAPORÃ;27;105;1040;343;230;113
TABAPORÃ;27;106;1040;339;244;95
TABAPORÃ;27;107;1040;334;247;87
NOVO HORIZONTE DO NORTE;27;108;1015;314;238;76
NOVO HORIZONTE DO NORTE;27;109;1015;317;244;73
NOVO HORIZONTE DO NORTE;27;110;1015;321;241;80
NOVO HORIZONTE DO NORTE;27;111;1015;313;235;78
NOVO HORIZONTE DO NORTE;27;112;1015;318;248;70
NOVO HORIZONTE DO NORTE;27;113;1058;353;256;97
NOVO HORIZONTE DO NORTE;27;114;1058;352;255;97
NOVO HORIZONTE DO NORTE;27;116;1058;186;138;48
NOVO HORIZONTE DO NORTE;27;117;1015;313;238;75
JUARA;27;121;1155;373;238;135
TABAPORÃ;27;122;1023;376;265;111
JUARA;27;123;1210;318;238;80
JUARA;27;124;1279;166;133;33
JUARA;27;125;1155;367;258;109
JUARA;27;126;1228;382;261;121
JUARA;27;127;1287;416;305;111
TABAPORÃ;27;128;1031;312;209;103
TABAPORÃ;27;129;1040;333;231;102
TABAPORÃ;27;130;1023;377;263;114
NOVO HORIZONTE DO NORTE;27;131;1015;314;220;94
JUARA;27;132;1040;357;225;132
PORTO DOS GAÚCHOS;27;133;1015;353;240;113
JUARA;27;135;1260;232;196;36
JUARA;27;136;1287;336;252;84
JUARA;27;137;1040;360;230;130
JUARA;27;138;1155;379;282;97
JUARA;27;139;1040;366;302;64
PORTO ALEGRE DO NORTE;28;76;1015;397;244;153
PORTO ALEGRE DO NORTE;28;77;1015;423;270;153
PORTO ALEGRE DO NORTE;28;78;1015;396;265;131
PORTO ALEGRE DO NORTE;28;81;1015;398;290;108
PORTO ALEGRE DO NORTE;28;85;1015;394;264;130
PORTO ALEGRE DO NORTE;28;86;1015;381;276;105
PORTO ALEGRE DO NORTE;28;87;1015;214;145;69
PORTO ALEGRE DO NORTE;28;87;1015;213;144;69
PORTO ALEGRE DO NORTE;28;89;1023;352;249;103
PORTO ALEGRE DO NORTE;28;90;1023;346;245;101
PORTO ALEGRE DO NORTE;28;91;1023;347;237;110
PORTO ALEGRE DO NORTE;28;92;1023;353;229;124
PORTO ALEGRE DO NORTE;28;93;1023;346;241;105
PORTO ALEGRE DO NORTE;28;94;1023;355;236;119
PORTO ALEGRE DO NORTE;28;95;1023;340;237;103
PORTO ALEGRE DO NORTE;28;96;1031;374;269;105
PORTO ALEGRE DO NORTE;28;97;1031;342;232;110
PORTO ALEGRE DO NORTE;28;98;1040;347;252;95
PORTO ALEGRE DO NORTE;28;99;1040;350;244;106
PORTO ALEGRE DO NORTE;28;100;1040;348;249;99
CONFRESA;28;101;1155;391;273;118
CONFRESA;28;102;1155;394;291;103
CONFRESA;28;103;1155;389;286;103
CONFRESA;28;104;1155;394;278;116
CONFRESA;28;105;1155;386;273;113
CONFRESA;28;106;1155;389;278;111
CONFRESA;28;107;1155;393;274;119
CONFRESA;28;108;1155;389;283;106
CONFRESA;28;109;1155;389;282;107
CONFRESA;28;110;1155;387;286;101
CONFRESA;28;111;1171;390;291;99
CONFRESA;28;112;1171;389;301;88
CONFRESA;28;113;1171;389;272;117
CONFRESA;28;114;1171;388;282;106
CONFRESA;28;115;1171;393;289;104
CONFRESA;28;116;1171;425;300;125
CONFRESA;28;117;1171;388;285;103
CONFRESA;28;118;1023;387;291;96
CONFRESA;28;119;1023;379;274;105
CONFRESA;28;120;1023;380;276;104
CONFRESA;28;121;1023;385;270;115
CONFRESA;28;122;1031;263;190;73
CONFRESA;28;123;1031;262;185;77
CONFRESA;28;124;1031;260;202;58
CONFRESA;28;125;1031;259;194;65
CONFRESA;28;126;1104;312;221;91
CONFRESA;28;127;1104;306;223;83
CONFRESA;28;128;1104;308;218;90
CONFRESA;28;129;1104;307;231;76
CONFRESA;28;130;1104;312;228;84
CONFRESA;28;131;1104;308;219;89
CONFRESA;28;132;1104;310;237;73
CONFRESA;28;133;1104;309;223;86
CONFRESA;28;134;1104;307;221;86
CONFRESA;28;135;1104;308;215;93
CONFRESA;28;136;1104;309;229;80
CANABRAVA DO NORTE;28;137;1015;218;147;71
CANABRAVA DO NORTE;28;138;1015;215;138;77
CANABRAVA DO NORTE;28;139;1015;220;160;60
CANABRAVA DO NORTE;28;140;1023;333;221;112
CANABRAVA DO NORTE;28;141;1023;328;242;86
CANABRAVA DO NORTE;28;142;1023;329;240;89
CANABRAVA DO NORTE;28;143;1023;330;241;89
CANABRAVA DO NORTE;28;144;1023;333;255;78
CANABRAVA DO NORTE;28;145;1023;331;227;104
CANABRAVA DO NORTE;28;146;1031;355;250;105
CANABRAVA DO NORTE;28;147;1031;349;232;117
CANABRAVA DO NORTE;28;148;1031;351;245;106
CONFRESA;28;149;1066;406;295;111
CONFRESA;28;150;1090;247;184;63
CONFRESA;28;151;1082;353;238;115
CONFRESA;28;152;1074;265;206;59
PORTO ALEGRE DO NORTE;28;153;1023;348;234;114
CONFRESA;28;154;1112;287;212;75
CONFRESA;28;155;1023;389;290;99
CONFRESA;28;156;1023;379;267;112
PORTO ALEGRE DO NORTE;28;157;1031;347;244;103
CONFRESA;28;158;1120;401;375;26
CONFRESA;28;159;1031;265;205;60
CONFRESA;28;160;1147;432;318;114
CONFRESA;28;161;1023;384;292;92
CONFRESA;28;162;1023;382;296;86
CONFRESA;28;163;1171;382;293;89
PORTO ALEGRE DO NORTE;28;164;1066;300;232;68
CONFRESA;28;165;1090;244;180;64
CONFRESA;28;166;1198;432;337;95
CONFRESA;28;167;1023;382;254;128
CONFRESA;28;168;1074;260;187;73
PORTO ALEGRE DO NORTE;28;170;1031;347;239;108
SÃO JOSÉ DO XINGU;28;172;1015;321;204;117
SÃO JOSÉ DO XINGU;28;173;1015;319;211;108
SÃO JOSÉ DO XINGU;28;174;1015;317;207;110
SÃO JOSÉ DO XINGU;28;175;1015;319;202;117
SÃO JOSÉ DO XINGU;28;176;1015;316;198;118
SÃO JOSÉ DO XINGU;28;177;1015;321;188;133
SÃO JOSÉ DO XINGU;28;178;1015;317;214;103
SÃO JOSÉ DO XINGU;28;179;1015;321;219;102
SÃO JOSÉ DO XINGU;28;181;1023;343;241;102
SÃO JOSÉ DO XINGU;28;182;1023;343;242;101
SÃO JOSÉ DO XINGU;28;183;1023;371;274;97
SÃO JOSÉ DO XINGU;28;184;1023;346;234;112
SÃO JOSÉ DO XINGU;28;185;1058;174;107;67
CONFRESA;28;186;1112;174;117;57
CONFRESA;28;187;1198;389;287;102
SÃO JOSÉ DO XINGU;28;188;1023;342;203;139
CONFRESA;28;189;1198;391;296;95
PORTO ALEGRE DO NORTE;28;190;1082;64;43;21
PORTO ALEGRE DO NORTE;28;191;1090;57;52;5
CONFRESA;28;192;1163;251;202;49
CONFRESA;28;193;1171;391;229;162
CONFRESA;28;194;1198;394;266;128
CONFRESA;28;195;1180;107;101;6
CONFRESA;28;196;1198;397;275;122
CONFRESA;28;198;1155;391;248;143
CONFRESA;28;199;1155;396;328;68
CONFRESA;28;202;1155;248;208;40
SÃO JOSÉ DO RIO CLARO;29;1;1015;384;276;108
SÃO JOSÉ DO RIO CLARO;29;2;1015;365;278;87
SÃO JOSÉ DO RIO CLARO;29;3;1015;375;276;99
SÃO JOSÉ DO RIO CLARO;29;4;1015;375;276;99
SÃO JOSÉ DO RIO CLARO;29;5;1015;378;271;107
SÃO JOSÉ DO RIO CLARO;29;6;1015;368;277;91
SÃO JOSÉ DO RIO CLARO;29;7;1023;267;185;82
SÃO JOSÉ DO RIO CLARO;29;8;1023;254;186;68
SÃO JOSÉ DO RIO CLARO;29;9;1023;258;201;57
SÃO JOSÉ DO RIO CLARO;29;10;1023;255;200;55
SÃO JOSÉ DO RIO CLARO;29;11;1023;261;185;76
SÃO JOSÉ DO RIO CLARO;29;12;1031;305;234;71
SÃO JOSÉ DO RIO CLARO;29;13;1031;304;221;83
SÃO JOSÉ DO RIO CLARO;29;14;1031;296;226;70
SÃO JOSÉ DO RIO CLARO;29;15;1031;321;225;96
SÃO JOSÉ DO RIO CLARO;29;16;1031;299;226;73
NOVA MARINGÁ;29;17;1023;251;178;73
NOVA MARINGÁ;29;18;1023;246;163;83
NOVA MARINGÁ;29;22;1015;317;231;86
NOVA MARINGÁ;29;23;1015;315;231;84
NOVA MARINGÁ;29;24;1015;316;241;75
SÃO JOSÉ DO RIO CLARO;29;25;1023;251;199;52
SÃO JOSÉ DO RIO CLARO;29;26;1023;251;196;55
SÃO JOSÉ DO RIO CLARO;29;27;1023;256;194;62
SÃO JOSÉ DO RIO CLARO;29;28;1023;253;190;63
SÃO JOSÉ DO RIO CLARO;29;29;1112;304;237;67
SÃO JOSÉ DO RIO CLARO;29;30;1031;290;196;94
SÃO JOSÉ DO RIO CLARO;29;31;1031;308;226;82
SÃO JOSÉ DO RIO CLARO;29;32;1031;289;196;93
NOVA MARINGÁ;29;33;1015;314;240;74
SÃO JOSÉ DO RIO CLARO;29;37;1023;251;196;55
SÃO JOSÉ DO RIO CLARO;29;38;1112;303;232;71
SÃO JOSÉ DO RIO CLARO;29;39;1210;333;236;97
NOVA MARINGÁ;29;40;1015;317;233;84
SÃO JOSÉ DO RIO CLARO;29;41;1155;230;171;59
SÃO JOSÉ DO RIO CLARO;29;42;1155;226;171;55
SÃO JOSÉ DO RIO CLARO;29;43;1210;345;238;107
SÃO JOSÉ DO RIO CLARO;29;44;1155;232;165;67
NOVA MARINGÁ;29;45;1040;362;251;111
NOVA MARINGÁ;29;46;1031;338;243;95
NOVA MARINGÁ;29;47;1040;360;255;105
NOVA MARINGÁ;29;48;1031;337;212;125
SÃO JOSÉ DO RIO CLARO;29;49;1155;223;162;61
NOVA MARINGÁ;29;50;1040;370;249;121
SÃO JOSÉ DO RIO CLARO;29;51;1155;225;172;53
SÃO JOSÉ DO RIO CLARO;29;52;1023;261;199;62
SÃO JOSÉ DO RIO CLARO;29;53;1031;287;202;85
SÃO JOSÉ DO RIO CLARO;29;54;1015;397;282;115
SÃO JOSÉ DO RIO CLARO;29;55;1112;311;226;85
SÃO JOSÉ DO RIO CLARO;29;57;1031;300;212;88
SÃO JOSÉ DO RIO CLARO;29;58;1015;365;262;103
NOVA MARINGÁ;29;59;1023;253;169;84
NOVA MARINGÁ;29;60;1040;177;136;41
ÁGUA BOA;30;1;1015;288;231;57
ÁGUA BOA;30;2;1015;283;224;59
ÁGUA BOA;30;3;1015;286;224;62
ÁGUA BOA;30;4;1147;236;187;49
ÁGUA BOA;30;5;1147;246;192;54
ÁGUA BOA;30;6;1040;256;174;82
ÁGUA BOA;30;7;1040;276;198;78
ÁGUA BOA;30;8;1040;265;203;62
ÁGUA BOA;30;9;1147;243;181;62
ÁGUA BOA;30;10;1147;245;181;64
ÁGUA BOA;30;11;1104;223;167;56
ÁGUA BOA;30;12;1104;224;173;51
ÁGUA BOA;30;13;1015;287;223;64
ÁGUA BOA;30;14;1040;269;205;64
ÁGUA BOA;30;15;1112;288;206;82
ÁGUA BOA;30;16;1112;289;216;73
ÁGUA BOA;30;17;1201;276;215;61
ÁGUA BOA;30;18;1201;267;209;58
ÁGUA BOA;30;19;1112;281;206;75
ÁGUA BOA;30;20;1104;215;170;45
ÁGUA BOA;30;21;1015;284;217;67
ÁGUA BOA;30;22;1066;258;172;86
ÁGUA BOA;30;23;1066;257;171;86
ÁGUA BOA;30;23;1066;256;170;86
ÁGUA BOA;30;24;1180;196;119;77
ÁGUA BOA;30;24;1180;195;118;77
NOVA NAZARÉ;30;26;1015;338;219;119
NOVA NAZARÉ;30;27;1015;314;215;99
ÁGUA BOA;30;28;1040;259;197;62
COCALINHO;30;29;1015;284;194;90
COCALINHO;30;30;1015;287;202;85
COCALINHO;30;31;1015;286;199;87
COCALINHO;30;32;1015;286;185;101
COCALINHO;30;33;1015;285;197;88
COCALINHO;30;34;1066;280;201;79
COCALINHO;30;35;1066;283;192;91
COCALINHO;30;36;1031;357;219;138
COCALINHO;30;38;1040;353;250;103
COCALINHO;30;40;1040;353;253;100
NOVA NAZARÉ;30;42;1015;322;225;97
ÁGUA BOA;30;43;1139;331;241;90
ÁGUA BOA;30;44;1015;269;178;91
ÁGUA BOA;30;45;1147;243;191;52
ÁGUA BOA;30;46;1201;264;216;48
ÁGUA BOA;30;47;1147;240;183;57
ÁGUA BOA;30;48;1163;276;210;66
ÁGUA BOA;30;49;1171;268;197;71
ÁGUA BOA;30;50;1104;226;179;47
ÁGUA BOA;30;51;1112;287;216;71
COCALINHO;30;52;1040;350;230;120
COCALINHO;30;52;1040;349;229;120
ÁGUA BOA;30;53;1015;301;202;99
ÁGUA BOA;30;54;1163;284;211;73
ÁGUA BOA;30;55;1198;247;170;77
ÁGUA BOA;30;56;1180;372;260;112
ÁGUA BOA;30;57;1201;268;224;44
COCALINHO;30;59;1015;283;194;89
NOVA NAZARÉ;30;60;1015;321;203;118
COCALINHO;30;62;1066;282;199;83
NOVA NAZARÉ;30;63;1015;306;189;117
ÁGUA BOA;30;64;1163;276;216;60
ÁGUA BOA;30;65;1198;245;180;65
ÁGUA BOA;30;66;1015;304;205;99
ÁGUA BOA;30;67;1171;267;195;72
ÁGUA BOA;30;68;1015;298;214;84
ÁGUA BOA;30;69;1163;292;205;87
ÁGUA BOA;30;71;1040;288;191;97
ÁGUA BOA;30;72;1112;295;202;93
ÁGUA BOA;30;73;1163;286;204;82
NOVA NAZARÉ;30;74;1015;306;196;110
ÁGUA BOA;30;75;1244;329;240;89
ÁGUA BOA;30;76;1040;283;172;111
ÁGUA BOA;30;77;1171;277;193;84
ÁGUA BOA;30;78;1198;244;168;76
COCALINHO;30;79;1015;284;180;104
ÁGUA BOA;30;80;1244;316;224;92
ÁGUA BOA;30;81;1015;292;196;96
ÁGUA BOA;30;82;1198;236;177;59
ÁGUA BOA;30;83;1171;248;166;82
ÁGUA BOA;30;84;1040;241;157;84
ÁGUA BOA;30;85;1112;281;200;81
ÁGUA BOA;30;86;1163;269;211;58
ÁGUA BOA;30;87;1201;266;223;43
ÁGUA BOA;30;87;1201;261;218;43
NOVA NAZARÉ;30;88;1015;280;174;106
ÁGUA BOA;30;89;1104;212;158;54
ÁGUA BOA;30;89;1104;211;157;54
ÁGUA BOA;30;90;1147;230;187;43
ÁGUA BOA;30;91;1015;265;182;83
ÁGUA BOA;30;92;1244;304;246;58
ÁGUA BOA;30;93;1163;262;209;53
ÁGUA BOA;30;95;1112;273;176;97
ÁGUA BOA;30;95;1112;272;175;97
ÁGUA BOA;30;96;1040;256;164;92
ÁGUA BOA;30;96;1040;253;161;92
ÁGUA BOA;30;97;1015;272;196;76
ÁGUA BOA;30;98;1163;261;187;74
ÁGUA BOA;30;99;1171;250;187;63
ÁGUA BOA;30;100;1244;303;228;75
ÁGUA BOA;30;101;1198;226;158;68
ÁGUA BOA;30;101;1198;225;158;67
ÁGUA BOA;30;102;1015;265;164;101
NOVA NAZARÉ;30;103;1015;288;175;113
COCALINHO;30;104;1066;281;175;106
COCALINHO;30;105;1015;282;162;120
NOVA NAZARÉ;30;106;1015;278;198;80
CANARANA;31;19;1015;379;296;83
CANARANA;31;20;1139;201;144;57
CANARANA;31;21;1139;209;151;58
CANARANA;31;22;1139;203;155;48
CANARANA;31;23;1139;384;268;116
CANARANA;31;24;1015;382;283;99
CANARANA;31;25;1015;386;299;87
CANARANA;31;26;1015;386;302;84
CANARANA;31;27;1090;329;241;88
CANARANA;31;28;1090;329;236;93
CANARANA;31;29;1090;322;232;90
CANARANA;31;30;1023;345;245;100
CANARANA;31;31;1023;352;236;116
CANARANA;31;32;1023;336;230;106
CANARANA;31;32;1023;334;228;106
CANARANA;31;33;1074;266;202;64
CANARANA;31;34;1040;231;157;74
CANARANA;31;35;1058;404;283;121
CANARANA;31;36;1066;179;129;50
CANARANA;31;42;1090;323;246;77
CANARANA;31;44;1090;309;238;71
CANARANA;31;45;1058;365;277;88
CANARANA;31;49;1015;396;298;98
CANARANA;31;50;1082;407;284;123
CANARANA;31;51;1015;388;300;88
CANARANA;31;52;1082;391;260;131
CANARANA;31;56;1082;395;277;118
CANARANA;31;62;1082;386;277;109
CANARANA;31;63;1066;178;142;36
CANARANA;31;64;1040;222;147;75
CANARANA;31;67;1082;398;278;120
CANARANA;31;68;1015;387;299;88
CANARANA;31;71;1082;400;276;124
CANARANA;31;72;1015;378;272;106
CANARANA;31;76;1023;342;232;110
CANARANA;31;78;1082;396;285;111
CANARANA;31;79;1015;391;275;116
CANARANA;31;83;1082;390;265;125
CANARANA;31;85;1112;425;320;105
CANARANA;31;86;1112;419;302;117
CANARANA;31;87;1112;435;307;128
CANARANA;31;89;1112;435;314;121
CANARANA;31;90;1112;428;329;99
CANARANA;31;92;1112;432;304;128
CANARANA;31;98;1015;399;271;128
RIBEIRÃO CASCALHEIRA;31;104;1015;297;220;77
RIBEIRÃO CASCALHEIRA;31;105;1015;301;217;84
RIBEIRÃO CASCALHEIRA;31;106;1015;297;214;83
RIBEIRÃO CASCALHEIRA;31;107;1015;299;219;80
RIBEIRÃO CASCALHEIRA;31;108;1015;301;210;91
RIBEIRÃO CASCALHEIRA;31;108;1015;300;209;91
RIBEIRÃO CASCALHEIRA;31;109;1023;251;168;83
RIBEIRÃO CASCALHEIRA;31;110;1023;255;184;71
RIBEIRÃO CASCALHEIRA;31;111;1023;255;198;57
RIBEIRÃO CASCALHEIRA;31;112;1023;256;190;66
RIBEIRÃO CASCALHEIRA;31;113;1023;254;186;68
RIBEIRÃO CASCALHEIRA;31;114;1023;254;178;76
RIBEIRÃO CASCALHEIRA;31;115;1023;255;193;62
RIBEIRÃO CASCALHEIRA;31;115;1023;254;192;62
RIBEIRÃO CASCALHEIRA;31;116;1023;253;207;46
RIBEIRÃO CASCALHEIRA;31;117;1023;253;193;60
RIBEIRÃO CASCALHEIRA;31;118;1023;252;200;52
RIBEIRÃO CASCALHEIRA;31;119;1023;256;183;73
RIBEIRÃO CASCALHEIRA;31;120;1040;384;260;124
RIBEIRÃO CASCALHEIRA;31;121;1040;195;141;54
RIBEIRÃO CASCALHEIRA;31;121;1040;194;141;53
RIBEIRÃO CASCALHEIRA;31;123;1058;382;267;115
RIBEIRÃO CASCALHEIRA;31;124;1058;380;251;129
RIBEIRÃO CASCALHEIRA;31;125;1058;381;241;140
RIBEIRÃO CASCALHEIRA;31;126;1066;226;141;85
RIBEIRÃO CASCALHEIRA;31;127;1066;230;156;74
RIBEIRÃO CASCALHEIRA;31;128;1066;222;157;65
RIBEIRÃO CASCALHEIRA;31;129;1066;228;139;89
RIBEIRÃO CASCALHEIRA;31;130;1058;379;239;140
CANARANA;31;131;1082;353;217;136
CANARANA;31;132;1015;347;231;116
CANARANA;31;133;1023;238;164;74
UNIÃO DO SUL;32;83;1015;304;226;78
UNIÃO DO SUL;32;84;1015;303;205;98
UNIÃO DO SUL;32;85;1015;303;244;59
UNIÃO DO SUL;32;86;1015;302;233;69
UNIÃO DO SUL;32;87;1015;303;231;72
UNIÃO DO SUL;32;88;1040;376;288;88
UNIÃO DO SUL;32;89;1040;374;289;85
UNIÃO DO SUL;32;90;1040;374;289;85
CLÁUDIA;32;91;1015;337;261;76
CLÁUDIA;32;92;1015;346;259;87
CLÁUDIA;32;93;1015;349;253;96
CLÁUDIA;32;94;1015;331;266;65
CLÁUDIA;32;95;1015;330;259;71
CLÁUDIA;32;96;1015;337;259;78
CLÁUDIA;32;97;1015;333;267;66
CLÁUDIA;32;98;1015;327;262;65
CLÁUDIA;32;99;1015;329;269;60
CLÁUDIA;32;100;1015;330;263;67
CLÁUDIA;32;101;1015;330;268;62
CLÁUDIA;32;102;1015;328;268;60
CLÁUDIA;32;103;1015;329;268;61
CLÁUDIA;32;104;1015;324;267;57
CLÁUDIA;32;105;1058;286;214;72
CLÁUDIA;32;106;1058;280;210;70
CLÁUDIA;32;107;1040;264;199;65
CLÁUDIA;32;108;1040;264;186;78
CLÁUDIA;32;109;1040;253;199;54
CLÁUDIA;32;110;1040;256;199;57
CLÁUDIA;32;111;1040;261;209;52
CLÁUDIA;32;112;1040;261;194;67
CLÁUDIA;32;113;1040;253;190;63
CLÁUDIA;32;113;1040;252;189;63
CLÁUDIA;32;213;1058;283;209;74
CLÁUDIA;32;214;1066;188;145;43
CLÁUDIA;32;215;1074;270;179;91
CLÁUDIA;32;216;1082;206;153;53
UNIÃO DO SUL;32;230;1040;379;250;129
MARCELÂNDIA;32;243;1015;291;211;80
MARCELÂNDIA;32;244;1015;286;200;86
MARCELÂNDIA;32;245;1015;289;217;72
MARCELÂNDIA;32;246;1015;288;190;98
MARCELÂNDIA;32;247;1015;291;201;90
MARCELÂNDIA;32;248;1015;288;200;88
MARCELÂNDIA;32;249;1015;288;195;93
MARCELÂNDIA;32;250;1015;285;205;80
MARCELÂNDIA;32;251;1015;287;192;95
MARCELÂNDIA;32;252;1104;388;283;105
MARCELÂNDIA;32;253;1104;252;173;79
MARCELÂNDIA;32;254;1104;253;188;65
MARCELÂNDIA;32;255;1104;257;154;103
MARCELÂNDIA;32;256;1104;259;164;95
MARCELÂNDIA;32;257;1023;278;185;93
MARCELÂNDIA;32;258;1023;276;181;95
MARCELÂNDIA;32;259;1023;279;191;88
MARCELÂNDIA;32;260;1023;274;192;82
MARCELÂNDIA;32;261;1023;277;205;72
MARCELÂNDIA;32;262;1023;275;196;79
MARCELÂNDIA;32;263;1023;275;196;79
MARCELÂNDIA;32;264;1023;276;187;89
MARCELÂNDIA;32;265;1023;277;199;78
MARCELÂNDIA;32;267;1031;277;196;81
MARCELÂNDIA;32;268;1031;277;190;87
MARCELÂNDIA;32;270;1040;335;237;98
MARCELÂNDIA;32;271;1040;339;214;125
MARCELÂNDIA;32;272;1040;339;236;103
MARCELÂNDIA;32;273;1040;341;218;123
MARCELÂNDIA;32;274;1058;263;194;69
CLÁUDIA;32;276;1074;169;119;50
MARCELÂNDIA;32;278;1090;100;90;10
MARCELÂNDIA;32;279;1074;164;132;32
PEIXOTO DE AZEVEDO;33;1;1015;389;292;97
PEIXOTO DE AZEVEDO;33;2;1015;395;273;122
PEIXOTO DE AZEVEDO;33;3;1015;388;272;116
PEIXOTO DE AZEVEDO;33;4;1015;374;282;92
PEIXOTO DE AZEVEDO;33;5;1015;391;284;107
PEIXOTO DE AZEVEDO;33;6;1015;392;290;102
PEIXOTO DE AZEVEDO;33;7;1015;398;296;102
PEIXOTO DE AZEVEDO;33;8;1015;393;279;114
PEIXOTO DE AZEVEDO;33;9;1015;401;293;108
PEIXOTO DE AZEVEDO;33;10;1015;372;267;105
PEIXOTO DE AZEVEDO;33;11;1015;346;251;95
PEIXOTO DE AZEVEDO;33;12;1015;348;246;102
PEIXOTO DE AZEVEDO;33;13;1015;341;253;88
PEIXOTO DE AZEVEDO;33;14;1015;341;275;66
PEIXOTO DE AZEVEDO;33;15;1015;344;256;88
PEIXOTO DE AZEVEDO;33;25;1023;210;155;55
PEIXOTO DE AZEVEDO;33;27;1023;207;163;44
PEIXOTO DE AZEVEDO;33;28;1023;203;157;46
PEIXOTO DE AZEVEDO;33;29;1023;208;164;44
PEIXOTO DE AZEVEDO;33;30;1023;214;167;47
PEIXOTO DE AZEVEDO;33;31;1023;215;150;65
PEIXOTO DE AZEVEDO;33;32;1023;209;157;52
PEIXOTO DE AZEVEDO;33;34;1201;283;216;67
PEIXOTO DE AZEVEDO;33;37;1201;301;232;69
PEIXOTO DE AZEVEDO;33;40;1058;309;232;77
PEIXOTO DE AZEVEDO;33;41;1058;299;232;67
PEIXOTO DE AZEVEDO;33;42;1147;224;168;56
PEIXOTO DE AZEVEDO;33;43;1147;228;161;67
PEIXOTO DE AZEVEDO;33;44;1147;222;173;49
PEIXOTO DE AZEVEDO;33;45;1058;300;226;74
PEIXOTO DE AZEVEDO;33;46;1023;212;150;62
MATUPÁ;33;47;1015;201;142;59
MATUPÁ;33;51;1015;204;139;65
MATUPÁ;33;54;1031;244;188;56
MATUPÁ;33;55;1031;248;191;57
MATUPÁ;33;56;1031;234;185;49
MATUPÁ;33;57;1031;243;191;52
MATUPÁ;33;58;1031;249;194;55
MATUPÁ;33;59;1031;249;191;58
MATUPÁ;33;60;1031;237;196;41
MATUPÁ;33;61;1031;243;178;65
MATUPÁ;33;62;1031;247;193;54
MATUPÁ;33;63;1066;305;221;84
MATUPÁ;33;64;1066;297;223;74
TERRA NOVA DO NORTE;33;65;1015;216;153;63
TERRA NOVA DO NORTE;33;67;1015;212;155;57
TERRA NOVA DO NORTE;33;70;1023;377;255;122
TERRA NOVA DO NORTE;33;71;1023;189;136;53
TERRA NOVA DO NORTE;33;73;1031;254;175;79
TERRA NOVA DO NORTE;33;78;1040;247;154;93
TERRA NOVA DO NORTE;33;81;1058;230;166;64
TERRA NOVA DO NORTE;33;82;1058;230;173;57
TERRA NOVA DO NORTE;33;83;1058;228;166;62
TERRA NOVA DO NORTE;33;84;1058;230;166;64
TERRA NOVA DO NORTE;33;84;1058;229;165;64
TERRA NOVA DO NORTE;33;85;1058;232;170;62
TERRA NOVA DO NORTE;33;86;1058;230;182;48
TERRA NOVA DO NORTE;33;87;1058;232;171;61
TERRA NOVA DO NORTE;33;88;1058;229;175;54
TERRA NOVA DO NORTE;33;89;1058;230;177;53
TERRA NOVA DO NORTE;33;90;1058;230;168;62
TERRA NOVA DO NORTE;33;91;1058;230;171;59
TERRA NOVA DO NORTE;33;92;1171;248;184;64
TERRA NOVA DO NORTE;33;93;1180;174;134;40
TERRA NOVA DO NORTE;33;94;1180;341;256;85
TERRA NOVA DO NORTE;33;95;1171;250;194;56
TERRA NOVA DO NORTE;33;96;1104;262;181;81
TERRA NOVA DO NORTE;33;97;1040;268;199;69
TERRA NOVA DO NORTE;33;98;1198;368;249;119
MATUPÁ;33;136;1066;293;213;80
MATUPÁ;33;136;1066;292;212;80
PEIXOTO DE AZEVEDO;33;137;1090;306;222;84
PEIXOTO DE AZEVEDO;33;138;1090;304;237;67
PEIXOTO DE AZEVEDO;33;139;1090;295;222;73
PEIXOTO DE AZEVEDO;33;140;1058;295;231;64
TERRA NOVA DO NORTE;33;141;1058;231;186;45
TERRA NOVA DO NORTE;33;142;1171;251;191;60
PEIXOTO DE AZEVEDO;33;143;1058;300;231;69
TERRA NOVA DO NORTE;33;144;1171;250;193;57
TERRA NOVA DO NORTE;33;145;1040;293;203;90
TERRA NOVA DO NORTE;33;146;1180;344;246;98
TERRA NOVA DO NORTE;33;147;1031;255;197;58
MATUPÁ;33;149;1031;247;199;48
MATUPÁ;33;150;1066;298;229;69
PEIXOTO DE AZEVEDO;33;151;1023;215;164;51
PEIXOTO DE AZEVEDO;33;152;1090;292;218;74
PEIXOTO DE AZEVEDO;33;153;1090;297;213;84
PEIXOTO DE AZEVEDO;33;154;1058;295;216;79
PEIXOTO DE AZEVEDO;33;155;1074;252;195;57
TERRA NOVA DO NORTE;33;156;1104;260;184;76
PEIXOTO DE AZEVEDO;33;160;1023;218;165;53
PEIXOTO DE AZEVEDO;33;161;1058;303;218;85
PEIXOTO DE AZEVEDO;33;162;1147;233;180;53
PEIXOTO DE AZEVEDO;33;164;1090;299;227;72
MATUPÁ;33;169;1031;251;190;61
MATUPÁ;33;171;1066;301;225;76
PEIXOTO DE AZEVEDO;33;174;1090;286;213;73
PEIXOTO DE AZEVEDO;33;175;1058;304;219;85
PEIXOTO DE AZEVEDO;33;176;1058;292;218;74
PEIXOTO DE AZEVEDO;33;177;1147;235;175;60
TERRA NOVA DO NORTE;33;178;1058;229;163;66
PEIXOTO DE AZEVEDO;33;182;1090;294;228;66
PEIXOTO DE AZEVEDO;33;183;1201;305;237;68
PEIXOTO DE AZEVEDO;33;184;1058;307;231;76
PEIXOTO DE AZEVEDO;33;185;1074;248;188;60
MATUPÁ;33;186;1066;310;224;86
PEIXOTO DE AZEVEDO;33;187;1201;298;219;79
TERRA NOVA DO NORTE;33;188;1171;253;188;65
MATUPÁ;33;190;1066;302;222;80
PEIXOTO DE AZEVEDO;33;191;1201;296;221;75
TERRA NOVA DO NORTE;33;194;1180;344;261;83
PEIXOTO DE AZEVEDO;33;200;1074;243;183;60
PEIXOTO DE AZEVEDO;33;201;1074;257;170;87
MATUPÁ;33;204;1066;298;220;78
MATUPÁ;33;205;1031;244;181;63
PEIXOTO DE AZEVEDO;33;209;1112;179;110;69
PEIXOTO DE AZEVEDO;33;209;1112;175;106;69
PEIXOTO DE AZEVEDO;33;210;1074;265;187;78
MATUPÁ;33;213;1066;310;226;84
MATUPÁ;33;215;1074;344;255;89
PEIXOTO DE AZEVEDO;33;217;1074;249;191;58
MATUPÁ;33;219;1066;308;219;89
PEIXOTO DE AZEVEDO;33;221;1074;246;192;54
MATUPÁ;33;222;1074;337;249;88
MATUPÁ;33;224;1104;362;256;106
MATUPÁ;33;225;1104;353;252;101
PEIXOTO DE AZEVEDO;33;228;1155;383;273;110
MATUPÁ;33;229;1074;342;248;94
PEIXOTO DE AZEVEDO;33;232;1155;381;268;113
PEIXOTO DE AZEVEDO;33;239;1155;386;271;115
NOVA GUARITA;33;241;1015;371;281;90
NOVA GUARITA;33;242;1015;373;274;99
NOVA GUARITA;33;243;1015;372;268;104
NOVA GUARITA;33;244;1015;373;263;110
NOVA GUARITA;33;245;1015;376;281;95
NOVA GUARITA;33;246;1015;372;280;92
NOVA GUARITA;33;247;1015;372;287;85
NOVA GUARITA;33;248;1015;372;284;88
NOVA GUARITA;33;249;1031;324;239;85
NOVA GUARITA;33;250;1031;223;156;67
PEIXOTO DE AZEVEDO;33;253;1147;233;172;61
MATUPÁ;33;254;1074;358;240;118
PEIXOTO DE AZEVEDO;33;255;1139;189;115;74
PEIXOTO DE AZEVEDO;33;255;1139;188;114;74
MATUPÁ;33;256;1104;347;250;97
PEIXOTO DE AZEVEDO;33;257;1155;385;275;110
PEIXOTO DE AZEVEDO;33;258;1155;388;259;129
PEIXOTO DE AZEVEDO;33;259;1163;378;284;94
PEIXOTO DE AZEVEDO;33;260;1155;387;255;132
PEIXOTO DE AZEVEDO;33;261;1201;301;225;76
PEIXOTO DE AZEVEDO;33;263;1171;233;180;53
MATUPÁ;33;264;1074;353;245;108
MATUPÁ;33;265;1074;334;250;84
MATUPÁ;33;267;1074;343;243;100
PEIXOTO DE AZEVEDO;33;270;1228;157;124;33
PEIXOTO DE AZEVEDO;33;271;1210;263;195;68
MATUPÁ;33;272;1074;354;249;105
NOVA GUARITA;33;273;1015;372;269;103
PEIXOTO DE AZEVEDO;33;274;1236;396;280;116
MATUPÁ;33;275;1074;325;253;72
PEIXOTO DE AZEVEDO;33;276;1244;348;249;99
MATUPÁ;33;277;1104;343;240;103
PEIXOTO DE AZEVEDO;33;278;1236;394;263;131
MATUPÁ;33;279;1112;391;319;72
MATUPÁ;33;280;1120;379;276;103
MATUPÁ;33;281;1112;385;296;89
MATUPÁ;33;282;1120;381;264;117
MATUPÁ;33;283;1112;388;281;107
MATUPÁ;33;284;1120;288;206;82
MATUPÁ;33;285;1112;149;118;31
NOVA BRASILÂNDIA;34;1;1015;313;240;73
NOVA BRASILÂNDIA;34;3;1015;310;248;62
NOVA BRASILÂNDIA;34;4;1023;436;326;110
NOVA BRASILÂNDIA;34;6;1023;433;341;92
NOVA BRASILÂNDIA;34;9;1147;227;166;61
NOVA BRASILÂNDIA;34;11;1015;311;227;84
NOVA BRASILÂNDIA;34;13;1015;309;231;78
NOVA BRASILÂNDIA;34;15;1023;436;336;100
NOVA BRASILÂNDIA;34;17;1015;311;239;72
NOVA BRASILÂNDIA;34;19;1023;438;324;114
PLANALTO DA SERRA;34;20;1015;381;289;92
NOVA BRASILÂNDIA;34;21;1147;147;107;40
PLANALTO DA SERRA;34;22;1023;253;199;54
PLANALTO DA SERRA;34;23;1023;250;195;55
PLANALTO DA SERRA;34;24;1058;353;282;71
PLANALTO DA SERRA;34;25;1058;352;279;73
PLANALTO DA SERRA;34;59;1040;111;89;22
CHAPADA DOS GUIMARÃES;34;64;1015;346;286;60
CHAPADA DOS GUIMARÃES;34;65;1015;343;273;70
CHAPADA DOS GUIMARÃES;34;66;1015;347;269;78
CHAPADA DOS GUIMARÃES;34;67;1015;347;261;86
CHAPADA DOS GUIMARÃES;34;68;1031;313;252;61
CHAPADA DOS GUIMARÃES;34;69;1031;314;245;69
CHAPADA DOS GUIMARÃES;34;70;1031;314;246;68
CHAPADA DOS GUIMARÃES;34;71;1031;333;249;84
CHAPADA DOS GUIMARÃES;34;72;1031;312;248;64
CHAPADA DOS GUIMARÃES;34;73;1031;313;243;70
CHAPADA DOS GUIMARÃES;34;74;1031;315;236;79
CHAPADA DOS GUIMARÃES;34;75;1031;310;252;58
CHAPADA DOS GUIMARÃES;34;76;1031;311;248;63
CHAPADA DOS GUIMARÃES;34;86;1082;379;281;98
CHAPADA DOS GUIMARÃES;34;88;1082;190;137;53
CHAPADA DOS GUIMARÃES;34;89;1082;378;287;91
CHAPADA DOS GUIMARÃES;34;91;1090;318;253;65
CHAPADA DOS GUIMARÃES;34;94;1112;64;52;12
CHAPADA DOS GUIMARÃES;34;97;1120;203;149;54
CHAPADA DOS GUIMARÃES;34;97;1120;202;148;54
CHAPADA DOS GUIMARÃES;34;98;1147;282;211;71
CHAPADA DOS GUIMARÃES;34;99;1155;364;282;82
CHAPADA DOS GUIMARÃES;34;100;1163;329;256;73
CHAPADA DOS GUIMARÃES;34;101;1171;237;178;59
CHAPADA DOS GUIMARÃES;34;102;1180;367;290;77
CHAPADA DOS GUIMARÃES;34;103;1198;383;269;114
CHAPADA DOS GUIMARÃES;34;104;1201;258;217;41
PLANALTO DA SERRA;34;105;1015;245;172;73
CHAPADA DOS GUIMARÃES;34;106;1139;254;198;56
CHAPADA DOS GUIMARÃES;34;109;1090;157;117;40
CHAPADA DOS GUIMARÃES;34;111;1180;366;292;74
CHAPADA DOS GUIMARÃES;34;113;1228;194;125;69
CHAPADA DOS GUIMARÃES;34;114;1147;274;203;71
CHAPADA DOS GUIMARÃES;34;115;1180;371;298;73
CHAPADA DOS GUIMARÃES;34;116;1236;121;92;29
CHAPADA DOS GUIMARÃES;34;117;1198;461;338;123
CHAPADA DOS GUIMARÃES;34;118;1180;357;291;66
CHAPADA DOS GUIMARÃES;34;120;1180;366;290;76
CHAPADA DOS GUIMARÃES;34;121;1180;363;287;76
CHAPADA DOS GUIMARÃES;34;122;1228;267;190;77
CHAPADA DOS GUIMARÃES;34;125;1147;393;299;94
CHAPADA DOS GUIMARÃES;34;126;1252;373;299;74
CHAPADA DOS GUIMARÃES;34;127;1260;296;234;62
CHAPADA DOS GUIMARÃES;34;128;1180;369;300;69
CHAPADA DOS GUIMARÃES;34;129;1201;375;308;67
PLANALTO DA SERRA;34;130;1058;354;266;88
CHAPADA DOS GUIMARÃES;34;131;1260;301;215;86
CHAPADA DOS GUIMARÃES;34;132;1139;349;250;99
CHAPADA DOS GUIMARÃES;34;133;1252;378;287;91
CHAPADA DOS GUIMARÃES;34;134;1260;298;233;65
CHAPADA DOS GUIMARÃES;34;135;1015;349;285;64
CHAPADA DOS GUIMARÃES;34;136;1180;368;270;98
CHAPADA DOS GUIMARÃES;34;137;1260;299;218;81
PLANALTO DA SERRA;34;138;1058;351;259;92
CHAPADA DOS GUIMARÃES;34;139;1180;364;246;118
CHAPADA DOS GUIMARÃES;34;140;1031;312;231;81
CHAPADA DOS GUIMARÃES;34;143;1180;371;270;101
CASTANHEIRA;35;27;1015;437;324;113
CASTANHEIRA;35;27;1015;436;323;113
CASTANHEIRA;35;29;1015;439;323;116
CASTANHEIRA;35;31;1015;433;327;106
CASTANHEIRA;35;33;1015;437;325;112
CASTANHEIRA;35;35;1015;438;330;108
CASTANHEIRA;35;37;1015;437;326;111
JUÍNA;35;49;1023;282;208;74
JUÍNA;35;50;1023;285;203;82
JUÍNA;35;51;1023;282;190;92
JUÍNA;35;52;1023;283;210;73
JUÍNA;35;53;1031;418;289;129
JUÍNA;35;55;1031;421;283;138
JUÍNA;35;55;1031;420;282;138
JUÍNA;35;57;1031;416;305;111
JUÍNA;35;59;1023;280;202;78
JUÍNA;35;60;1023;278;203;75
JUÍNA;35;61;1023;285;218;67
JUÍNA;35;62;1023;279;213;66
JUÍNA;35;63;1023;283;201;82
JUÍNA;35;64;1023;282;217;65
JUÍNA;35;65;1023;284;214;70
JUÍNA;35;66;1031;417;313;104
JUÍNA;35;68;1031;415;293;122
JUÍNA;35;70;1031;414;291;123
JUÍNA;35;72;1031;416;296;120
JUÍNA;35;73;1040;112;77;35
JUÍNA;35;74;1058;386;260;126
JUÍNA;35;75;1066;362;271;91
JUÍNA;35;76;1066;360;267;93
JUÍNA;35;77;1066;361;254;107
JUÍNA;35;78;1066;360;273;87
JUÍNA;35;79;1074;373;260;113
JUÍNA;35;83;1074;372;277;95
JUÍNA;35;86;1082;368;216;152
JUÍNA;35;90;1341;394;273;121
JUÍNA;35;91;1252;278;207;71
JUÍNA;35;94;1031;417;300;117
JUÍNA;35;95;1228;310;236;74
JUÍNA;35;96;1228;314;209;105
JUÍNA;35;96;1228;313;208;105
JUÍNA;35;97;1147;100;76;24
JUÍNA;35;99;1066;365;258;107
JUÍNA;35;100;1163;340;260;80
JUÍNA;35;102;1171;357;249;108
JUÍNA;35;102;1171;356;248;108
JUÍNA;35;103;1171;349;239;110
JUÍNA;35;104;1171;351;248;103
JUÍNA;35;105;1171;352;257;95
JUÍNA;35;106;1171;349;248;101
CASTANHEIRA;35;109;1023;138;114;24
CASTANHEIRA;35;110;1015;431;313;118
JUÍNA;35;115;1023;282;210;72
CASTANHEIRA;35;118;1015;433;304;129
JUÍNA;35;120;1023;282;218;64
JUÍNA;35;122;1066;365;276;89
JUÍNA;35;123;1082;366;260;106
JUÍNA;35;124;1171;350;251;99
JUÍNA;35;125;1180;233;168;65
JUÍNA;35;126;1201;331;214;117
JUÍNA;35;127;1236;231;166;65
JUÍNA;35;128;1317;99;85;14
JUÍNA;35;141;1198;349;271;78
JUÍNA;35;142;1210;385;261;124
JUÍNA;35;143;1228;312;222;90
CASTANHEIRA;35;146;1015;435;328;107
CASTANHEIRA;35;149;1015;432;296;136
JUÍNA;35;163;1198;347;249;98
JUÍNA;35;164;1228;305;215;90
JUÍNA;35;166;1210;384;273;111
JUÍNA;35;168;1201;323;222;101
JUÍNA;35;176;1198;344;252;92
JUÍNA;35;177;1180;231;166;65
CASTANHEIRA;35;178;1104;106;82;24
CASTANHEIRA;35;179;1090;342;256;86
JUÍNA;35;181;1236;231;164;67
JUÍNA;35;182;1210;384;274;110
JUÍNA;35;182;1210;383;273;110
JUÍNA;35;190;1279;200;155;45
JUÍNA;35;192;1210;380;264;116
JUÍNA;35;196;1228;305;221;84
JUÍNA;35;197;1198;352;265;87
JUÍNA;35;199;1201;330;227;103
JUÍNA;35;205;1210;385;289;96
JUÍNA;35;206;1236;231;161;70
JUÍNA;35;228;1171;353;256;97
JUÍNA;35;229;1287;184;157;27
JUÍNA;35;230;1295;253;183;70
JUÍNA;35;231;1309;189;146;43
JUÍNA;35;237;1228;310;203;107
JUÍNA;35;237;1228;309;202;107
JUÍNA;35;239;1210;382;277;105
CASTANHEIRA;35;240;1120;267;207;60
CASTANHEIRA;35;242;1112;157;127;30
CASTANHEIRA;35;242;1112;156;126;30
CASTANHEIRA;35;253;1147;156;120;36
JUÍNA;35;254;1180;231;170;61
JUÍNA;35;257;1201;327;218;109
JUÍNA;35;257;1201;326;217;109
JUÍNA;35;267;1295;246;167;79
JUÍNA;35;271;1198;349;255;94
JUÍNA;35;292;1066;360;270;90
JUÍNA;35;293;1210;385;244;141
CASTANHEIRA;35;294;1120;209;169;40
CASTANHEIRA;35;294;1120;208;168;40
JUÍNA;35;295;1180;207;127;80
JUÍNA;35;307;1210;380;254;126
JUÍNA;35;308;1228;308;217;91
JUÍNA;35;309;1295;245;181;64
JUÍNA;35;310;1210;379;262;117
JUÍNA;35;311;1180;231;159;72
JUÍNA;35;312;1333;63;52;11
JUÍNA;35;313;1210;383;263;120
JUÍNA;35;314;1198;344;246;98
JUÍNA;35;316;1201;328;212;116
JUÍNA;35;316;1201;327;211;116
JUÍNA;35;317;1341;384;283;101
JUÍNA;35;318;1295;250;173;77
JUÍNA;35;319;1341;389;274;115
JUÍNA;35;320;1341;394;277;117
JUÍNA;35;321;1350;232;208;24
JUÍNA;35;322;1180;232;173;59
JUÍNA;35;323;1023;284;201;83
JUÍNA;35;325;1228;314;215;99
JUÍNA;35;326;1066;364;275;89
JUÍNA;35;327;1201;333;250;83
JUÍNA;35;328;1295;250;190;60
JUÍNA;35;329;1198;351;258;93
JUÍNA;35;330;1341;398;286;112
JUÍNA;35;333;1210;383;270;113
JUÍNA;35;334;1236;233;180;53
JUÍNA;35;336;1368;348;250;98
JUÍNA;35;337;1341;132;112;20
FELIZ NATAL;36;44;1015;284;203;81
FELIZ NATAL;36;45;1015;282;201;81
FELIZ NATAL;36;46;1015;286;201;85
FELIZ NATAL;36;47;1015;285;211;74
FELIZ NATAL;36;48;1015;284;216;68
FELIZ NATAL;36;49;1015;287;226;61
FELIZ NATAL;36;50;1015;280;223;57
FELIZ NATAL;36;51;1015;279;220;59
FELIZ NATAL;36;52;1015;284;220;64
FELIZ NATAL;36;53;1015;283;210;73
FELIZ NATAL;36;54;1023;439;273;166
FELIZ NATAL;36;56;1040;286;206;80
FELIZ NATAL;36;57;1040;280;191;89
FELIZ NATAL;36;58;1040;290;213;77
FELIZ NATAL;36;59;1040;267;205;62
FELIZ NATAL;36;60;1040;271;200;71
FELIZ NATAL;36;61;1040;274;203;71
FELIZ NATAL;36;62;1040;271;203;68
FELIZ NATAL;36;63;1040;283;217;66
FELIZ NATAL;36;64;1040;275;184;91
FELIZ NATAL;36;65;1058;380;275;105
VERA;36;66;1015;305;224;81
VERA;36;67;1015;302;234;68
VERA;36;68;1015;307;226;81
VERA;36;69;1015;314;228;86
VERA;36;70;1015;309;224;85
VERA;36;71;1015;301;234;67
VERA;36;72;1015;296;223;73
VERA;36;73;1015;312;228;84
VERA;36;74;1015;302;229;73
VERA;36;75;1015;298;230;68
VERA;36;76;1015;311;228;83
VERA;36;77;1015;304;225;79
VERA;36;78;1015;303;208;95
VERA;36;80;1031;354;254;100
VERA;36;81;1031;352;274;78
VERA;36;82;1031;349;269;80
VERA;36;83;1031;355;262;93
VERA;36;84;1031;353;255;98
VERA;36;85;1031;354;259;95
VERA;36;86;1031;358;263;95
VERA;36;87;1031;363;268;95
VERA;36;88;1031;350;262;88
SANTA CARMEM;36;141;1015;284;204;80
SANTA CARMEM;36;142;1015;293;209;84
SANTA CARMEM;36;143;1015;291;213;78
SANTA CARMEM;36;144;1015;304;230;74
SANTA CARMEM;36;145;1015;274;218;56
SANTA CARMEM;36;147;1015;280;210;70
SANTA CARMEM;36;148;1015;291;219;72
SANTA CARMEM;36;149;1015;267;210;57
SANTA CARMEM;36;150;1015;287;212;75
FELIZ NATAL;36;151;1058;107;92;15
FELIZ NATAL;36;151;1058;104;89;15
SANTA CARMEM;36;152;1015;380;319;61
SANTA CARMEM;36;153;1015;384;331;53
SANTA CARMEM;36;154;1015;364;306;58
BARÃO DE MELGAÇO;38;80;1031;336;274;62
BARÃO DE MELGAÇO;38;81;1031;347;295;52
BARÃO DE MELGAÇO;38;82;1031;385;296;89
BARÃO DE MELGAÇO;38;83;1031;388;323;65
BARÃO DE MELGAÇO;38;84;1031;387;319;68
BARÃO DE MELGAÇO;38;85;1031;339;282;57
BARÃO DE MELGAÇO;38;86;1031;341;284;57
BARÃO DE MELGAÇO;38;87;1058;242;195;47
BARÃO DE MELGAÇO;38;88;1058;247;200;47
BARÃO DE MELGAÇO;38;89;1058;249;186;63
BARÃO DE MELGAÇO;38;92;1074;239;180;59
BARÃO DE MELGAÇO;38;94;1082;366;325;41
BARÃO DE MELGAÇO;38;95;1082;211;175;36
BARÃO DE MELGAÇO;38;96;1104;264;203;61
BARÃO DE MELGAÇO;38;97;1104;294;231;63
BARÃO DE MELGAÇO;38;98;1112;73;59;14
SANTO ANTÔNIO DO LEVERGER;38;100;1031;304;255;49
SANTO ANTÔNIO DO LEVERGER;38;101;1031;304;257;47
SANTO ANTÔNIO DO LEVERGER;38;102;1031;302;259;43
SANTO ANTÔNIO DO LEVERGER;38;103;1031;304;258;46
SANTO ANTÔNIO DO LEVERGER;38;104;1627;350;291;59
SANTO ANTÔNIO DO LEVERGER;38;105;1627;344;296;48
SANTO ANTÔNIO DO LEVERGER;38;106;1031;305;256;49
SANTO ANTÔNIO DO LEVERGER;38;107;1031;303;266;37
SANTO ANTÔNIO DO LEVERGER;38;108;1040;358;310;48
SANTO ANTÔNIO DO LEVERGER;38;109;1040;358;296;62
SANTO ANTÔNIO DO LEVERGER;38;110;1040;359;299;60
SANTO ANTÔNIO DO LEVERGER;38;111;1040;361;312;49
SANTO ANTÔNIO DO LEVERGER;38;112;1031;304;260;44
SANTO ANTÔNIO DO LEVERGER;38;113;1031;303;261;42
SANTO ANTÔNIO DO LEVERGER;38;114;1031;304;267;37
SANTO ANTÔNIO DO LEVERGER;38;115;1090;325;280;45
SANTO ANTÔNIO DO LEVERGER;38;116;1090;338;291;47
SANTO ANTÔNIO DO LEVERGER;38;117;1104;208;173;35
SANTO ANTÔNIO DO LEVERGER;38;118;1104;336;236;100
SANTO ANTÔNIO DO LEVERGER;38;119;1104;338;276;62
SANTO ANTÔNIO DO LEVERGER;38;120;1546;356;290;66
SANTO ANTÔNIO DO LEVERGER;38;120;1546;355;289;66
SANTO ANTÔNIO DO LEVERGER;38;122;1546;241;205;36
SANTO ANTÔNIO DO LEVERGER;38;123;1430;276;206;70
SANTO ANTÔNIO DO LEVERGER;38;125;1171;227;164;63
SANTO ANTÔNIO DO LEVERGER;38;126;1163;205;152;53
SANTO ANTÔNIO DO LEVERGER;38;127;1171;365;297;68
SANTO ANTÔNIO DO LEVERGER;38;129;1171;360;266;94
SANTO ANTÔNIO DO LEVERGER;38;131;1171;361;273;88
SANTO ANTÔNIO DO LEVERGER;38;132;1090;261;226;35
SANTO ANTÔNIO DO LEVERGER;38;134;1210;190;155;35
SANTO ANTÔNIO DO LEVERGER;38;136;1546;348;275;73
SANTO ANTÔNIO DO LEVERGER;38;137;1090;259;230;29
SANTO ANTÔNIO DO LEVERGER;38;138;1384;297;196;101
SANTO ANTÔNIO DO LEVERGER;38;140;1040;359;265;94
SANTO ANTÔNIO DO LEVERGER;38;142;1384;316;200;116
SANTO ANTÔNIO DO LEVERGER;38;158;1627;345;270;75
SANTO ANTÔNIO DO LEVERGER;38;159;1210;373;279;94
SANTO ANTÔNIO DO LEVERGER;38;161;1090;326;278;48
SANTO ANTÔNIO DO LEVERGER;38;162;1040;360;316;44
SANTO ANTÔNIO DO LEVERGER;38;165;1104;345;255;90
SANTO ANTÔNIO DO LEVERGER;38;181;1376;160;151;9
SANTO ANTÔNIO DO LEVERGER;38;183;1546;266;190;76
SANTO ANTÔNIO DO LEVERGER;38;186;1040;363;278;85
BARÃO DE MELGAÇO;38;190;1139;80;71;9
BARÃO DE MELGAÇO;38;191;1147;299;252;47
SANTO ANTÔNIO DO LEVERGER;38;197;1392;152;124;28
SANTO ANTÔNIO DO LEVERGER;38;209;1384;334;252;82
SANTO ANTÔNIO DO LEVERGER;38;212;1104;338;248;90
BARÃO DE MELGAÇO;38;213;1058;240;186;54
SANTO ANTÔNIO DO LEVERGER;38;215;1457;308;241;67
BARÃO DE MELGAÇO;38;217;1031;388;312;76
SANTO ANTÔNIO DO LEVERGER;38;220;1040;357;296;61
SANTO ANTÔNIO DO LEVERGER;38;222;1546;335;262;73
SANTO ANTÔNIO DO LEVERGER;38;226;1040;354;296;58
SANTO ANTÔNIO DO LEVERGER;38;228;1627;343;268;75
BARÃO DE MELGAÇO;38;230;1104;236;174;62
SANTO ANTÔNIO DO LEVERGER;38;233;1180;192;171;21
SANTO ANTÔNIO DO LEVERGER;38;236;1600;188;174;14
BARÃO DE MELGAÇO;38;237;1090;58;55;3
BARÃO DE MELGAÇO;38;237;1090;57;54;3
BARÃO DE MELGAÇO;38;239;1155;125;119;6
CUIABÁ;39;364;1708;392;340;52
CUIABÁ;39;366;1708;390;349;41
CUIABÁ;39;368;1708;391;342;49
CUIABÁ;39;370;1708;387;340;47
CUIABÁ;39;372;2267;404;338;66
CUIABÁ;39;374;2267;405;334;71
CUIABÁ;39;376;2267;404;327;77
CUIABÁ;39;378;2267;203;172;31
CUIABÁ;39;379;1732;400;327;73
CUIABÁ;39;382;1732;391;328;63
CUIABÁ;39;385;1732;393;339;54
CUIABÁ;39;388;1732;289;237;52
CUIABÁ;39;389;1740;317;261;56
CUIABÁ;39;390;1740;322;271;51
CUIABÁ;39;391;1740;317;265;52
CUIABÁ;39;392;1740;316;264;52
CUIABÁ;39;393;1740;317;255;62
CUIABÁ;39;394;1740;314;272;42
CUIABÁ;39;395;1740;316;271;45
CUIABÁ;39;396;1740;318;273;45
CUIABÁ;39;397;1740;315;272;43
CUIABÁ;39;398;1740;313;277;36
CUIABÁ;39;399;1740;316;269;47
CUIABÁ;39;400;1740;312;262;50
CUIABÁ;39;401;1740;317;266;51
CUIABÁ;39;402;1759;330;273;57
CUIABÁ;39;404;1759;326;260;66
CUIABÁ;39;406;1759;322;275;47
CUIABÁ;39;408;1759;326;277;49
CUIABÁ;39;411;1775;299;252;47
CUIABÁ;39;412;1775;302;257;45
CUIABÁ;39;413;1775;304;255;49
CUIABÁ;39;414;1775;302;244;58
CUIABÁ;39;415;1775;304;250;54
CUIABÁ;39;416;1775;300;254;46
CUIABÁ;39;417;1775;300;249;51
CUIABÁ;39;418;1775;297;239;58
CUIABÁ;39;419;1775;301;260;41
CUIABÁ;39;420;1775;301;250;51
CUIABÁ;39;421;1775;300;254;46
CUIABÁ;39;422;1775;298;253;45
CUIABÁ;39;423;1775;296;258;38
CUIABÁ;39;424;1783;396;327;69
CUIABÁ;39;425;1783;394;338;56
CUIABÁ;39;426;1783;394;326;68
CUIABÁ;39;427;1783;394;336;58
CUIABÁ;39;428;1783;387;328;59
CUIABÁ;39;429;1783;395;322;73
CUIABÁ;39;430;1791;305;269;36
CUIABÁ;39;432;1791;301;255;46
CUIABÁ;39;434;1791;301;257;44
CUIABÁ;39;436;1791;302;264;38
CUIABÁ;39;438;1791;298;271;27
CUIABÁ;39;440;1805;302;258;44
CUIABÁ;39;440;1805;301;257;44
CUIABÁ;39;441;1805;300;254;46
CUIABÁ;39;442;1805;303;257;46
CUIABÁ;39;443;1805;301;252;49
CUIABÁ;39;444;1805;303;256;47
CUIABÁ;39;445;1805;303;258;45
CUIABÁ;39;446;1805;301;249;52
CUIABÁ;39;447;1805;302;253;49
CUIABÁ;39;448;1813;259;226;33
CUIABÁ;39;449;1813;256;226;30
CUIABÁ;39;450;1813;257;230;27
CUIABÁ;39;451;1813;261;224;37
CUIABÁ;39;452;1813;259;231;28
CUIABÁ;39;453;1813;255;224;31
CUIABÁ;39;454;1821;292;245;47
CUIABÁ;39;455;1821;288;248;40
CUIABÁ;39;456;1821;285;252;33
CUIABÁ;39;457;1821;291;254;37
CUIABÁ;39;458;1821;288;251;37
CUIABÁ;39;459;1821;287;250;37
CUIABÁ;39;460;1821;288;248;40
CUIABÁ;39;461;1830;410;352;58
CUIABÁ;39;463;1830;405;334;71
CUIABÁ;39;465;1848;259;218;41
CUIABÁ;39;466;1848;259;220;39
CUIABÁ;39;467;1848;257;213;44
CUIABÁ;39;468;1848;259;217;42
CUIABÁ;39;469;1848;251;202;49
CUIABÁ;39;470;1848;258;217;41
CUIABÁ;39;471;1856;334;284;50
CUIABÁ;39;473;1856;399;332;67
CUIABÁ;39;473;1856;337;272;65
CUIABÁ;39;475;1856;334;285;49
CUIABÁ;39;477;1856;337;277;60
CUIABÁ;39;479;1856;402;367;35
CUIABÁ;39;479;1856;270;241;29
CUIABÁ;39;480;1864;352;299;53
CUIABÁ;39;481;1864;356;288;68
CUIABÁ;39;482;1864;357;303;54
CUIABÁ;39;483;1864;351;284;67
CUIABÁ;39;484;1864;355;303;52
CUIABÁ;39;485;1864;353;305;48
CUIABÁ;39;487;1864;350;280;70
CUIABÁ;39;488;1864;351;294;57
CUIABÁ;39;489;1864;350;288;62
CUIABÁ;39;490;1872;296;261;35
CUIABÁ;39;491;1872;298;245;53
CUIABÁ;39;491;1872;297;244;53
CUIABÁ;39;492;1872;294;235;59
CUIABÁ;39;493;1872;294;247;47
CUIABÁ;39;494;1872;298;250;48
CUIABÁ;39;495;1872;293;233;60
CUIABÁ;39;496;1880;284;249;35
CUIABÁ;39;497;1880;284;237;47
CUIABÁ;39;498;1880;287;235;52
CUIABÁ;39;499;1880;282;237;45
CUIABÁ;39;500;1880;287;236;51
CUIABÁ;39;501;1880;283;230;53
CUIABÁ;39;502;1880;282;240;42
CUIABÁ;39;503;1880;284;250;34
CUIABÁ;39;504;1880;281;245;36
CUIABÁ;39;505;1880;286;240;46
CUIABÁ;39;506;1880;286;241;45
CUIABÁ;39;507;1899;239;207;32
CUIABÁ;39;508;1899;238;197;41
CUIABÁ;39;509;1899;237;198;39
CUIABÁ;39;510;1899;241;206;35
CUIABÁ;39;511;1899;237;206;31
CUIABÁ;39;512;1899;243;206;37
CUIABÁ;39;513;1899;235;199;36
CUIABÁ;39;514;1902;385;336;49
CUIABÁ;39;515;1902;391;332;59
CUIABÁ;39;516;1902;387;321;66
CUIABÁ;39;517;1902;388;325;63
CUIABÁ;39;518;1902;390;336;54
CUIABÁ;39;519;1910;307;265;42
CUIABÁ;39;520;1910;313;273;40
CUIABÁ;39;521;1910;313;274;39
CUIABÁ;39;522;1910;312;268;44
CUIABÁ;39;523;1929;287;262;25
CUIABÁ;39;524;1929;282;255;27
CUIABÁ;39;525;1929;283;244;39
CUIABÁ;39;526;1929;284;241;43
CUIABÁ;39;527;1945;290;235;55
CUIABÁ;39;527;1945;289;234;55
CUIABÁ;39;528;1945;288;247;41
CUIABÁ;39;529;1945;287;232;55
CUIABÁ;39;530;1945;289;249;40
CUIABÁ;39;531;1945;282;243;39
CUIABÁ;39;532;1945;290;244;46
CUIABÁ;39;533;1945;283;236;47
CUIABÁ;39;534;1945;285;242;43
CUIABÁ;39;535;1945;281;238;43
CUIABÁ;39;535;1945;277;234;43
CUIABÁ;39;536;1945;283;245;38
CUIABÁ;39;537;1945;285;225;60
CUIABÁ;39;538;1945;286;239;47
CUIABÁ;39;539;1945;286;238;48
CUIABÁ;39;540;1945;281;221;60
CUIABÁ;39;541;1945;289;238;51
CUIABÁ;39;542;1953;297;271;26
CUIABÁ;39;543;1953;297;260;37
CUIABÁ;39;544;1953;294;243;51
CUIABÁ;39;545;1961;378;322;56
CUIABÁ;39;546;1961;381;322;59
CUIABÁ;39;547;1961;381;322;59
CUIABÁ;39;548;1961;380;317;63
CUIABÁ;39;549;1961;378;327;51
CUIABÁ;39;550;1961;383;332;51
CUIABÁ;39;551;1961;383;325;58
CUIABÁ;39;552;1961;385;337;48
CUIABÁ;39;553;1961;382;314;68
CUIABÁ;39;554;1961;382;337;45
CUIABÁ;39;555;1961;380;325;55
CUIABÁ;39;556;1961;382;328;54
CUIABÁ;39;557;1961;381;328;53
CUIABÁ;39;558;1961;381;325;56
CUIABÁ;39;559;1970;265;223;42
CUIABÁ;39;560;1970;262;216;46
CUIABÁ;39;561;1970;267;209;58
CUIABÁ;39;562;1970;264;224;40
CUIABÁ;39;563;1970;261;222;39
CUIABÁ;39;565;1970;268;218;50
CUIABÁ;39;566;1970;264;218;46
CUIABÁ;39;567;1970;261;203;58
CUIABÁ;39;568;1988;267;229;38
CUIABÁ;39;569;1988;274;235;39
CUIABÁ;39;570;1988;272;237;35
CUIABÁ;39;571;1988;274;234;40
CUIABÁ;39;572;1988;269;240;29
CUIABÁ;39;573;1988;272;240;32
CUIABÁ;39;574;1988;272;240;32
CUIABÁ;39;575;1988;276;233;43
CUIABÁ;39;576;1988;271;235;36
CUIABÁ;39;577;1988;275;244;31
CUIABÁ;39;578;1988;270;230;40
CUIABÁ;39;579;1988;352;289;63
CUIABÁ;39;580;1996;281;241;40
CUIABÁ;39;581;1996;284;245;39
CUIABÁ;39;582;1996;273;226;47
CUIABÁ;39;583;1996;280;234;46
CUIABÁ;39;584;1996;278;238;40
CUIABÁ;39;585;1996;276;228;48
CUIABÁ;39;586;1996;273;238;35
CUIABÁ;39;587;2003;393;343;50
CUIABÁ;39;588;2003;394;327;67
CUIABÁ;39;589;2003;394;327;67
CUIABÁ;39;590;2003;389;307;82
CUIABÁ;39;590;2003;388;306;82
CUIABÁ;39;591;2003;393;316;77
CUIABÁ;39;592;2003;390;324;66
CUIABÁ;39;593;2003;388;320;68
CUIABÁ;39;594;2003;391;332;59
CUIABÁ;39;594;2003;390;331;59
CUIABÁ;39;595;2003;391;313;78
CUIABÁ;39;596;2011;390;327;63
CUIABÁ;39;597;2011;394;348;46
CUIABÁ;39;598;2011;390;319;71
CUIABÁ;39;599;2011;390;323;67
CUIABÁ;39;600;2011;394;328;66
CUIABÁ;39;601;2011;394;330;64
CUIABÁ;39;602;2011;387;323;64
CUIABÁ;39;603;2011;397;337;60
CUIABÁ;39;604;2011;387;332;55
CUIABÁ;39;605;2011;393;332;61
CUIABÁ;39;606;2020;258;216;42
CUIABÁ;39;607;2020;252;209;43
CUIABÁ;39;608;2020;259;234;25
CUIABÁ;39;609;2020;259;221;38
CUIABÁ;39;610;2020;259;227;32
CUIABÁ;39;611;2038;397;336;61
CUIABÁ;39;612;2038;393;352;41
CUIABÁ;39;613;2038;393;345;48
CUIABÁ;39;614;2038;393;342;51
CUIABÁ;39;615;2038;396;346;50
CUIABÁ;39;616;2038;399;345;54
CUIABÁ;39;617;2038;395;335;60
CUIABÁ;39;618;2038;393;334;59
CUIABÁ;39;619;2038;395;344;51
CUIABÁ;39;620;2038;387;324;63
CUIABÁ;39;621;2038;398;329;69
CUIABÁ;39;622;2038;390;331;59
CUIABÁ;39;623;2046;396;352;44
CUIABÁ;39;624;2046;398;349;49
CUIABÁ;39;625;2046;393;341;52
CUIABÁ;39;626;2046;394;349;45
CUIABÁ;39;627;2046;393;342;51
CUIABÁ;39;628;2046;391;342;49
CUIABÁ;39;629;2046;391;346;45
CUIABÁ;39;630;2046;391;341;50
CUIABÁ;39;631;2046;397;344;53
CUIABÁ;39;632;2046;391;335;56
CUIABÁ;39;633;2046;397;345;52
CUIABÁ;39;634;2208;297;245;52
CUIABÁ;39;638;2208;372;300;72
CUIABÁ;39;641;2062;300;250;50
CUIABÁ;39;642;2062;302;260;42
CUIABÁ;39;643;2062;298;255;43
CUIABÁ;39;644;2062;298;248;50
CUIABÁ;39;645;2062;298;250;48
CUIABÁ;39;646;2070;324;286;38
CUIABÁ;39;647;2070;322;277;45
CUIABÁ;39;648;2070;326;269;57
CUIABÁ;39;649;2070;325;283;42
CUIABÁ;39;650;2070;329;282;47
CUIABÁ;39;651;2070;328;273;55
CUIABÁ;39;652;2070;321;279;42
CUIABÁ;39;653;2070;328;277;51
CUIABÁ;39;654;2100;388;310;78
CUIABÁ;39;655;2100;392;306;86
CUIABÁ;39;656;2100;390;318;72
CUIABÁ;39;657;2100;390;314;76
CUIABÁ;39;658;2100;390;317;73
CUIABÁ;39;659;2100;396;315;81
CUIABÁ;39;660;2119;353;306;47
CUIABÁ;39;661;2119;355;294;61
CUIABÁ;39;662;2127;391;315;76
CUIABÁ;39;663;2127;396;323;73
CUIABÁ;39;664;2151;395;339;56
CUIABÁ;39;665;2151;393;341;52
CUIABÁ;39;666;2151;392;330;62
CUIABÁ;39;667;2151;382;313;69
CUIABÁ;39;668;2151;387;333;54
CUIABÁ;39;669;2151;391;332;59
CUIABÁ;39;670;2151;388;315;73
CUIABÁ;39;671;2151;395;321;74
CUIABÁ;39;672;2151;387;326;61
CUIABÁ;39;673;2151;394;344;50
CUIABÁ;39;674;1988;270;233;37
CUIABÁ;39;675;1988;271;233;38
CUIABÁ;39;676;2062;303;264;39
CUIABÁ;39;678;2216;237;203;34
CUIABÁ;39;679;2216;236;193;43
CUIABÁ;39;680;2216;237;200;37
CUIABÁ;39;681;2216;236;203;33
CUIABÁ;39;682;2216;238;201;37
CUIABÁ;39;683;2216;234;193;41
CUIABÁ;39;684;2216;235;198;37
CUIABÁ;39;685;2216;234;205;29
CUIABÁ;39;686;2224;395;331;64
CUIABÁ;39;687;2224;387;323;64
CUIABÁ;39;688;2224;394;325;69
CUIABÁ;39;689;2224;390;316;74
CUIABÁ;39;690;2224;391;317;74
CUIABÁ;39;691;2224;387;311;76
CUIABÁ;39;692;2224;392;303;89
CUIABÁ;39;693;2224;392;304;88
CUIABÁ;39;694;2046;394;355;39
CUIABÁ;39;695;2224;400;307;93
CUIABÁ;39;696;2011;385;328;57
CUIABÁ;39;697;2100;395;322;73
CUIABÁ;39;698;2224;399;333;66
CUIABÁ;39;699;2119;357;286;71
CUIABÁ;39;700;2232;385;351;34
CUIABÁ;39;701;1902;396;323;73
CUIABÁ;39;702;2259;392;326;66
CUIABÁ;39;703;2240;376;318;58
CUIABÁ;39;704;1961;380;331;49
CUIABÁ;39;705;2062;300;248;52
CUIABÁ;39;706;1783;397;330;67
CUIABÁ;39;707;2232;391;348;43
CUIABÁ;39;708;2100;394;302;92
CUIABÁ;39;709;2259;388;331;57
CUIABÁ;39;710;2224;395;325;70
CUIABÁ;39;711;2232;381;334;47
CUIABÁ;39;712;2232;382;320;62
CUIABÁ;39;713;2259;384;313;71
CUIABÁ;39;714;2100;389;302;87
CUIABÁ;39;715;1910;310;237;73
CUIABÁ;39;716;1783;395;311;84
CUIABÁ;39;717;2232;383;317;66
CUIABÁ;39;718;2240;382;315;67
CUIABÁ;39;719;1988;275;231;44
CUIABÁ;39;720;2232;383;300;83
CUIABÁ;39;721;2259;387;271;116
CUIABÁ;39;722;2240;390;355;35
CUIABÁ;39;723;2100;389;308;81
CUIABÁ;39;724;2259;397;345;52
CUIABÁ;39;725;2224;396;328;68
CUIABÁ;39;726;2240;262;227;35
CUIABÁ;39;727;2100;198;159;39
CUIABÁ;39;728;2259;207;171;36
CUIABÁ;39;729;2003;434;389;45
CUIABÁ;39;729;2003;211;186;25
PRIMAVERA DO LESTE;40;1;1015;309;241;68
PRIMAVERA DO LESTE;40;2;1015;312;254;58
PRIMAVERA DO LESTE;40;3;1015;308;257;51
PRIMAVERA DO LESTE;40;4;1015;307;239;68
PRIMAVERA DO LESTE;40;5;1015;309;251;58
PRIMAVERA DO LESTE;40;6;1015;311;246;65
PRIMAVERA DO LESTE;40;7;1015;304;248;56
PRIMAVERA DO LESTE;40;8;1015;310;257;53
PRIMAVERA DO LESTE;40;9;1015;302;237;65
PRIMAVERA DO LESTE;40;10;1023;391;327;64
PRIMAVERA DO LESTE;40;11;1023;391;318;73
PRIMAVERA DO LESTE;40;12;1023;395;323;72
PRIMAVERA DO LESTE;40;13;1023;388;326;62
PRIMAVERA DO LESTE;40;14;1023;390;325;65
PRIMAVERA DO LESTE;40;15;1023;385;316;69
PRIMAVERA DO LESTE;40;16;1023;391;314;77
PRIMAVERA DO LESTE;40;17;1210;377;299;78
PRIMAVERA DO LESTE;40;18;1210;379;314;65
PRIMAVERA DO LESTE;40;19;1210;381;305;76
PRIMAVERA DO LESTE;40;20;1040;393;292;101
PRIMAVERA DO LESTE;40;21;1040;396;298;98
PRIMAVERA DO LESTE;40;22;1040;392;286;106
PRIMAVERA DO LESTE;40;23;1040;393;301;92
PRIMAVERA DO LESTE;40;24;1210;378;314;64
PRIMAVERA DO LESTE;40;25;1058;326;269;57
PRIMAVERA DO LESTE;40;26;1058;324;257;67
PRIMAVERA DO LESTE;40;27;1040;395;297;98
PRIMAVERA DO LESTE;40;28;1058;324;255;69
PRIMAVERA DO LESTE;40;29;1066;340;281;59
PRIMAVERA DO LESTE;40;30;1139;307;268;39
PRIMAVERA DO LESTE;40;31;1210;384;318;66
PRIMAVERA DO LESTE;40;32;1040;396;282;114
PRIMAVERA DO LESTE;40;33;1058;322;268;54
PRIMAVERA DO LESTE;40;34;1139;311;271;40
PRIMAVERA DO LESTE;40;35;1040;393;296;97
PRIMAVERA DO LESTE;40;36;1082;329;245;84
PRIMAVERA DO LESTE;40;37;1139;310;266;44
PRIMAVERA DO LESTE;40;38;1058;326;256;70
PRIMAVERA DO LESTE;40;39;1210;374;308;66
PRIMAVERA DO LESTE;40;40;1040;394;281;113
PRIMAVERA DO LESTE;40;41;1066;338;280;58
PRIMAVERA DO LESTE;40;42;1139;304;263;41
PRIMAVERA DO LESTE;40;43;1058;323;262;61
PRIMAVERA DO LESTE;40;44;1082;323;253;70
PRIMAVERA DO LESTE;40;45;1090;336;263;73
PRIMAVERA DO LESTE;40;46;1104;330;269;61
PRIMAVERA DO LESTE;40;47;1112;388;276;112
PRIMAVERA DO LESTE;40;48;1112;388;266;122
PRIMAVERA DO LESTE;40;49;1090;332;268;64
PRIMAVERA DO LESTE;40;50;1139;312;272;40
PRIMAVERA DO LESTE;40;51;1112;377;279;98
PRIMAVERA DO LESTE;40;52;1066;338;280;58
PRIMAVERA DO LESTE;40;53;1104;327;260;67
PRIMAVERA DO LESTE;40;54;1120;138;109;29
PRIMAVERA DO LESTE;40;55;1090;330;268;62
PRIMAVERA DO LESTE;40;56;1082;328;267;61
PRIMAVERA DO LESTE;40;57;1090;332;273;59
PRIMAVERA DO LESTE;40;58;1082;329;238;91
PRIMAVERA DO LESTE;40;63;1139;307;258;49
PRIMAVERA DO LESTE;40;64;1104;324;270;54
PRIMAVERA DO LESTE;40;65;1082;329;259;70
PRIMAVERA DO LESTE;40;66;1058;324;252;72
PRIMAVERA DO LESTE;40;67;1139;307;266;41
PRIMAVERA DO LESTE;40;68;1082;326;269;57
PRIMAVERA DO LESTE;40;69;1058;329;271;58
PRIMAVERA DO LESTE;40;71;1139;303;262;41
PRIMAVERA DO LESTE;40;72;1082;326;251;75
PRIMAVERA DO LESTE;40;73;1147;390;307;83
PRIMAVERA DO LESTE;40;74;1058;320;255;65
PRIMAVERA DO LESTE;40;76;1082;323;248;75
PRIMAVERA DO LESTE;40;77;1058;320;250;70
PRIMAVERA DO LESTE;40;78;1023;387;309;78
PRIMAVERA DO LESTE;40;79;1104;333;269;64
PRIMAVERA DO LESTE;40;81;1058;321;247;74
PRIMAVERA DO LESTE;40;82;1082;328;261;67
PRIMAVERA DO LESTE;40;83;1066;342;273;69
PRIMAVERA DO LESTE;40;84;1163;373;306;67
PRIMAVERA DO LESTE;40;85;1040;391;295;96
PRIMAVERA DO LESTE;40;86;1171;391;280;111
PRIMAVERA DO LESTE;40;87;1015;312;257;55
PRIMAVERA DO LESTE;40;88;1058;317;247;70
PRIMAVERA DO LESTE;40;89;1040;389;285;104
PRIMAVERA DO LESTE;40;90;1147;391;310;81
PRIMAVERA DO LESTE;40;91;1163;367;290;77
PRIMAVERA DO LESTE;40;92;1058;327;250;77
PRIMAVERA DO LESTE;40;93;1210;378;294;84
PRIMAVERA DO LESTE;40;94;1015;308;240;68
PRIMAVERA DO LESTE;40;95;1163;366;288;78
PRIMAVERA DO LESTE;40;96;1180;308;256;52
PRIMAVERA DO LESTE;40;97;1171;392;287;105
PRIMAVERA DO LESTE;40;98;1023;392;302;90
PRIMAVERA DO LESTE;40;99;1163;372;309;63
PRIMAVERA DO LESTE;40;100;1066;340;270;70
PRIMAVERA DO LESTE;40;101;1040;390;286;104
PRIMAVERA DO LESTE;40;102;1180;310;238;72
PRIMAVERA DO LESTE;40;103;1163;371;287;84
PRIMAVERA DO LESTE;40;104;1040;394;273;121
PRIMAVERA DO LESTE;40;105;1104;330;266;64
PRIMAVERA DO LESTE;40;168;1023;389;301;88
PRIMAVERA DO LESTE;40;169;1171;387;284;103
PRIMAVERA DO LESTE;40;169;1171;386;283;103
PRIMAVERA DO LESTE;40;170;1180;312;232;80
PRIMAVERA DO LESTE;40;171;1201;300;227;73
PRIMAVERA DO LESTE;40;172;1210;381;312;69
PRIMAVERA DO LESTE;40;173;1163;366;302;64
PRIMAVERA DO LESTE;40;174;1139;312;264;48
PRIMAVERA DO LESTE;40;175;1066;343;256;87
PRIMAVERA DO LESTE;40;176;1163;373;291;82
PRIMAVERA DO LESTE;40;177;1171;388;271;117
PRIMAVERA DO LESTE;40;178;1040;396;279;117
PRIMAVERA DO LESTE;40;179;1147;388;297;91
PRIMAVERA DO LESTE;40;180;1163;372;297;75
PRIMAVERA DO LESTE;40;181;1180;315;224;91
PRIMAVERA DO LESTE;40;182;1171;388;278;110
PRIMAVERA DO LESTE;40;183;1210;378;316;62
PRIMAVERA DO LESTE;40;185;1104;332;276;56
PRIMAVERA DO LESTE;40;186;1058;328;227;101
PRIMAVERA DO LESTE;40;187;1171;385;287;98
PRIMAVERA DO LESTE;40;188;1163;376;297;79
PRIMAVERA DO LESTE;40;189;1201;298;239;59
PRIMAVERA DO LESTE;40;190;1171;388;275;113
PRIMAVERA DO LESTE;40;191;1228;342;272;70
PRIMAVERA DO LESTE;40;192;1139;318;275;43
PRIMAVERA DO LESTE;40;193;1228;338;242;96
PRIMAVERA DO LESTE;40;194;1163;375;307;68
PRIMAVERA DO LESTE;40;195;1228;340;283;57
PRIMAVERA DO LESTE;40;196;1104;333;277;56
PRIMAVERA DO LESTE;40;197;1228;346;283;63
PRIMAVERA DO LESTE;40;198;1228;346;277;69
PRIMAVERA DO LESTE;40;199;1180;317;225;92
PRIMAVERA DO LESTE;40;200;1082;327;219;108
PRIMAVERA DO LESTE;40;201;1163;373;284;89
PRIMAVERA DO LESTE;40;202;1228;344;264;80
PRIMAVERA DO LESTE;40;203;1201;293;210;83
PRIMAVERA DO LESTE;40;205;1228;342;274;68
PRIMAVERA DO LESTE;40;206;1228;336;249;87
PRIMAVERA DO LESTE;40;207;1201;297;219;78
SANTO ANTÔNIO DO LESTE;40;208;1015;242;178;64
SANTO ANTÔNIO DO LESTE;40;209;1015;253;158;95
SANTO ANTÔNIO DO LESTE;40;210;1015;250;166;84
SANTO ANTÔNIO DO LESTE;40;211;1015;245;174;71
SANTO ANTÔNIO DO LESTE;40;212;1015;260;169;91
SANTO ANTÔNIO DO LESTE;40;213;1015;246;174;72
SANTO ANTÔNIO DO LESTE;40;214;1015;248;171;77
PRIMAVERA DO LESTE;40;215;1180;316;199;117
PRIMAVERA DO LESTE;40;216;1147;387;268;119
PRIMAVERA DO LESTE;40;217;1171;385;234;151
PRIMAVERA DO LESTE;40;218;1210;380;277;103
PRIMAVERA DO LESTE;40;219;1201;296;221;75
SANTO ANTÔNIO DO LESTE;40;220;1015;317;249;68
PRIMAVERA DO LESTE;40;221;1171;384;244;140
SANTO ANTÔNIO DO LESTE;40;222;1015;382;277;105
SANTO ANTÔNIO DO LESTE;40;223;1015;198;111;87
PRIMAVERA DO LESTE;40;224;1171;398;332;66
PRIMAVERA DO LESTE;40;225;1171;234;186;48
ARAPUTANGA;41;1;1015;404;288;116
ARAPUTANGA;41;2;1015;391;287;104
ARAPUTANGA;41;3;1015;401;298;103
ARAPUTANGA;41;4;1015;406;281;125
ARAPUTANGA;41;5;1015;405;273;132
ARAPUTANGA;41;6;1015;398;280;118
ARAPUTANGA;41;7;1015;396;292;104
ARAPUTANGA;41;8;1015;404;288;116
ARAPUTANGA;41;9;1015;407;282;125
ARAPUTANGA;41;10;1074;356;244;112
ARAPUTANGA;41;11;1074;342;266;76
ARAPUTANGA;41;12;1074;360;268;92
ARAPUTANGA;41;13;1074;354;263;91
ARAPUTANGA;41;14;1074;344;258;86
ARAPUTANGA;41;14;1074;343;257;86
ARAPUTANGA;41;15;1074;342;274;68
ARAPUTANGA;41;16;1074;352;255;97
ARAPUTANGA;41;17;1074;341;254;87
ARAPUTANGA;41;18;1023;374;270;104
ARAPUTANGA;41;19;1023;372;276;96
ARAPUTANGA;41;20;1023;382;279;103
ARAPUTANGA;41;21;1023;382;290;92
ARAPUTANGA;41;22;1023;390;285;105
ARAPUTANGA;41;23;1023;370;285;85
ARAPUTANGA;41;24;1031;303;231;72
ARAPUTANGA;41;26;1040;287;217;70
ARAPUTANGA;41;26;1040;286;216;70
ARAPUTANGA;41;28;1040;280;210;70
ARAPUTANGA;41;30;1066;346;257;89
RESERVA DO CABAÇAL;41;32;1015;354;240;114
RESERVA DO CABAÇAL;41;34;1015;350;256;94
RESERVA DO CABAÇAL;41;36;1015;354;245;109
RESERVA DO CABAÇAL;41;38;1015;355;255;100
RESERVA DO CABAÇAL;41;40;1015;352;257;95
RESERVA DO CABAÇAL;41;42;1015;183;130;53
INDIAVAÍ;41;43;1023;230;180;50
INDIAVAÍ;41;44;1023;240;185;55
INDIAVAÍ;41;45;1023;238;188;50
INDIAVAÍ;41;46;1023;227;184;43
INDIAVAÍ;41;47;1023;229;182;47
INDIAVAÍ;41;48;1023;223;174;49
INDIAVAÍ;41;49;1023;233;179;54
ARAPUTANGA;41;50;1023;376;266;110
ARAPUTANGA;41;51;1023;376;279;97
ARAPUTANGA;41;53;1015;412;282;130
FIGUEIRÓPOLIS D'OESTE;41;54;1015;422;295;127
FIGUEIRÓPOLIS D'OESTE;41;57;1015;419;309;110
FIGUEIRÓPOLIS D'OESTE;41;60;1015;417;293;124
FIGUEIRÓPOLIS D'OESTE;41;61;1023;324;237;87
FIGUEIRÓPOLIS D'OESTE;41;64;1023;335;263;72
FIGUEIRÓPOLIS D'OESTE;41;67;1023;333;244;89
FIGUEIRÓPOLIS D'OESTE;41;72;1023;344;252;92
FIGUEIRÓPOLIS D'OESTE;41;73;1015;433;284;149
JAURU;41;78;1040;307;208;99
JAURU;41;80;1040;301;211;90
JAURU;41;81;1040;262;157;105
JAURU;41;82;1040;259;181;78
JAURU;41;83;1040;254;154;100
JAURU;41;83;1040;253;153;100
JAURU;41;84;1031;434;285;149
JAURU;41;86;1031;431;290;141
JAURU;41;88;1040;307;213;94
JAURU;41;90;1040;304;197;107
JAURU;41;92;1040;300;217;83
JAURU;41;93;1040;255;163;92
JAURU;41;95;1040;303;223;80
JAURU;41;97;1040;261;171;90
JAURU;41;98;1040;252;155;97
JAURU;41;99;1040;263;167;96
JAURU;41;100;1040;248;150;98
JAURU;41;102;1031;430;282;148
JAURU;41;104;1031;429;293;136
JAURU;41;106;1031;429;270;159
JAURU;41;108;1031;428;262;166
JAURU;41;110;1031;215;139;76
JAURU;41;111;1120;369;237;132
JAURU;41;114;1120;367;243;124
JAURU;41;117;1120;244;181;63
ARAPUTANGA;41;119;1074;351;249;102
ARAPUTANGA;41;120;1090;263;171;92
ARAPUTANGA;41;121;1023;362;247;115
INDIAVAÍ;41;124;1023;157;125;32
INDIAVAÍ;41;125;1023;155;121;34
SAPEZAL;42;68;1015;390;278;112
SAPEZAL;42;69;1015;383;271;112
SAPEZAL;42;70;1015;389;272;117
SAPEZAL;42;71;1015;391;288;103
SAPEZAL;42;72;1015;387;279;108
SAPEZAL;42;73;1015;383;280;103
SAPEZAL;42;74;1015;390;267;123
SAPEZAL;42;75;1015;380;262;118
SAPEZAL;42;76;1015;382;272;110
SAPEZAL;42;77;1015;387;266;121
SAPEZAL;42;78;1015;388;277;111
SAPEZAL;42;79;1015;385;279;106
SAPEZAL;42;80;1015;379;270;109
SAPEZAL;42;81;1015;383;274;109
SAPEZAL;42;82;1015;384;265;119
SAPEZAL;42;83;1031;421;316;105
SAPEZAL;42;84;1031;414;295;119
SAPEZAL;42;85;1031;420;319;101
SAPEZAL;42;86;1031;416;273;143
SAPEZAL;42;87;1023;420;307;113
SAPEZAL;42;88;1023;431;295;136
SAPEZAL;42;89;1023;423;295;128
SAPEZAL;42;90;1023;431;304;127
SAPEZAL;42;91;1023;413;287;126
SAPEZAL;42;92;1023;416;298;118
SAPEZAL;42;93;1031;413;286;127
SAPEZAL;42;94;1031;412;289;123
SAPEZAL;42;95;1031;410;317;93
SAPEZAL;42;96;1031;418;298;120
CAMPOS DE JÚLIO;42;97;1015;377;281;96
CAMPOS DE JÚLIO;42;98;1015;375;288;87
CAMPOS DE JÚLIO;42;99;1015;374;287;87
CAMPOS DE JÚLIO;42;100;1015;371;284;87
CAMPOS DE JÚLIO;42;101;1015;374;274;100
CAMPOS DE JÚLIO;42;102;1015;378;269;109
CAMPOS DE JÚLIO;42;103;1015;374;267;107
CAMPOS DE JÚLIO;42;105;1040;383;287;96
CAMPOS DE JÚLIO;42;106;1040;384;275;109
CAMPOS DE JÚLIO;42;107;1040;378;270;108
CAMPOS DE JÚLIO;42;108;1040;377;281;96
CAMPOS DE JÚLIO;42;109;1040;379;274;105
CAMPOS DE JÚLIO;42;110;1040;385;278;107
SAPEZAL;42;111;1023;421;291;130
SAPEZAL;42;112;1031;416;305;111
SAPEZAL;42;113;1023;433;284;149
SAPEZAL;42;114;1015;399;241;158
CAMPOS DE JÚLIO;42;115;1015;375;294;81
SAPEZAL;42;116;1031;428;282;146
SAPEZAL;42;117;1058;391;272;119
SAPEZAL;42;118;1058;395;277;118
SAPEZAL;42;119;1058;394;252;142
SAPEZAL;42;120;1058;384;289;95
SAPEZAL;42;121;1058;387;296;91
SAPEZAL;42;122;1058;402;270;132
SAPEZAL;42;123;1058;394;271;123
SAPEZAL;42;124;1058;366;262;104
SAPEZAL;42;125;1058;362;255;107
SAPEZAL;42;126;1058;360;217;143
SAPEZAL;42;127;1015;360;211;149
SAPEZAL;42;128;1015;362;219;143
SAPEZAL;42;129;1015;361;192;169
SAPEZAL;42;130;1023;388;303;85
SORRISO;43;19;1015;387;309;78
SORRISO;43;20;1015;385;293;92
SORRISO;43;21;1015;393;308;85
SORRISO;43;22;1015;380;311;69
SORRISO;43;23;1023;247;219;28
SORRISO;43;24;1023;249;222;27
SORRISO;43;25;1031;414;329;85
SORRISO;43;26;1031;406;308;98
SORRISO;43;27;1031;425;337;88
SORRISO;43;28;1031;414;318;96
SORRISO;43;29;1031;409;336;73
SORRISO;43;30;1031;406;328;78
SORRISO;43;31;1031;399;323;76
SORRISO;43;32;1031;404;336;68
SORRISO;43;33;1031;421;324;97
SORRISO;43;34;1031;413;339;74
SORRISO;43;35;1031;408;341;67
SORRISO;43;36;1040;406;335;71
SORRISO;43;37;1040;407;341;66
SORRISO;43;38;1040;408;324;84
SORRISO;43;39;1040;397;318;79
SORRISO;43;40;1040;420;329;91
NOVA UBIRATÃ;43;46;1015;390;287;103
NOVA UBIRATÃ;43;47;1015;387;289;98
NOVA UBIRATÃ;43;48;1015;387;300;87
SORRISO;43;54;1244;422;302;120
SORRISO;43;55;1295;401;296;105
SORRISO;43;55;1295;400;295;105
SORRISO;43;59;1015;385;315;70
SORRISO;43;60;1031;410;336;74
SORRISO;43;61;1040;414;327;87
SORRISO;43;64;1147;403;315;88
SORRISO;43;68;1015;397;328;69
NOVA UBIRATÃ;43;69;1023;231;173;58
NOVA UBIRATÃ;43;70;1074;347;240;107
NOVA UBIRATÃ;43;71;1040;127;83;44
NOVA UBIRATÃ;43;73;1058;260;167;93
NOVA UBIRATÃ;43;74;1015;390;294;96
SORRISO;43;77;1031;399;339;60
SORRISO;43;84;1244;410;304;106
SORRISO;43;85;1015;368;304;64
SORRISO;43;86;1015;381;303;78
SORRISO;43;87;1040;411;316;95
SORRISO;43;88;1244;408;304;104
SORRISO;43;93;1147;412;341;71
NOVA UBIRATÃ;43;96;1082;334;253;81
NOVA UBIRATÃ;43;98;1074;345;249;96
NOVA UBIRATÃ;43;99;1066;345;255;90
SORRISO;43;100;1147;408;335;73
SORRISO;43;108;1147;408;334;74
NOVA UBIRATÃ;43;120;1015;384;305;79
SORRISO;43;121;1147;405;337;68
SORRISO;43;124;1180;381;283;98
SORRISO;43;125;1210;431;321;110
SORRISO;43;126;1201;385;306;79
SORRISO;43;137;1244;407;306;101
SORRISO;43;141;1201;383;305;78
NOVA UBIRATÃ;43;147;1015;390;295;95
SORRISO;43;148;1180;397;307;90
SORRISO;43;151;1201;393;300;93
SORRISO;43;153;1244;411;304;107
SORRISO;43;155;1147;410;330;80
NOVA UBIRATÃ;43;156;1015;386;281;105
SORRISO;43;158;1015;393;317;76
SORRISO;43;160;1210;425;324;101
SORRISO;43;161;1201;378;289;89
SORRISO;43;163;1031;408;338;70
NOVA UBIRATÃ;43;164;1066;343;248;95
SORRISO;43;165;1252;424;333;91
SORRISO;43;167;1457;411;289;122
SORRISO;43;168;1040;407;308;99
SORRISO;43;170;1201;387;292;95
SORRISO;43;171;1180;388;288;100
SORRISO;43;175;1457;418;296;122
SORRISO;43;176;1201;392;295;97
SORRISO;43;179;1015;395;327;68
NOVA UBIRATÃ;43;180;1015;383;276;107
NOVA UBIRATÃ;43;181;1082;331;249;82
IPIRANGA DO NORTE;43;182;1015;275;201;74
IPIRANGA DO NORTE;43;183;1015;268;206;62
IPIRANGA DO NORTE;43;184;1015;283;204;79
IPIRANGA DO NORTE;43;185;1015;289;209;80
IPIRANGA DO NORTE;43;186;1023;288;208;80
IPIRANGA DO NORTE;43;187;1023;279;212;67
IPIRANGA DO NORTE;43;188;1023;285;206;79
IPIRANGA DO NORTE;43;189;1023;279;203;76
IPIRANGA DO NORTE;43;190;1023;289;208;81
SORRISO;43;191;1201;391;302;89
SORRISO;43;193;1252;428;347;81
SORRISO;43;195;1180;392;288;104
SORRISO;43;197;1201;383;298;85
SORRISO;43;202;1015;389;317;72
NOVA UBIRATÃ;43;203;1066;346;240;106
SORRISO;43;204;1201;395;283;112
SORRISO;43;205;1147;406;331;75
NOVA UBIRATÃ;43;206;1015;386;284;102
IPIRANGA DO NORTE;43;208;1015;294;208;86
SORRISO;43;209;1457;419;291;128
SORRISO;43;210;1180;390;290;100
SORRISO;43;212;1201;390;290;100
SORRISO;43;213;1023;234;198;36
SORRISO;43;214;1295;419;341;78
SORRISO;43;215;1252;413;326;87
SORRISO;43;216;1210;409;321;88
SORRISO;43;220;1031;441;328;113
SORRISO;43;220;1031;440;327;113
SORRISO;43;222;1147;385;305;80
SORRISO;43;223;1180;389;283;106
IPIRANGA DO NORTE;43;224;1023;275;200;75
SORRISO;43;225;1201;352;278;74
SORRISO;43;226;1295;393;319;74
NOVA UBIRATÃ;43;227;1015;388;253;135
SORRISO;43;228;1015;364;269;95
SORRISO;43;229;1252;392;305;87
SORRISO;43;230;1147;378;298;80
SORRISO;43;231;1309;396;300;96
SORRISO;43;232;1309;395;306;89
SORRISO;43;233;1210;447;338;109
SORRISO;43;234;1295;395;325;70
SORRISO;43;235;1201;373;288;85
SORRISO;43;236;1317;337;277;60
SORRISO;43;237;1317;320;276;44
SORRISO;43;238;1317;331;271;60
SORRISO;43;239;1317;332;268;64
SORRISO;43;240;1317;334;280;54
SORRISO;43;241;1317;325;277;48
SORRISO;43;242;1317;324;281;43
SORRISO;43;243;1317;334;275;59
SORRISO;43;244;1317;319;286;33
SORRISO;43;245;1317;333;277;56
SORRISO;43;246;1317;324;280;44
SORRISO;43;247;1317;324;280;44
SORRISO;43;248;1317;319;275;44
SORRISO;43;249;1317;324;279;45
SORRISO;43;250;1317;337;281;56
SORRISO;43;251;1317;324;265;59
SORRISO;43;252;1317;352;280;72
SORRISO;43;252;1317;351;279;72
SORRISO;43;253;1325;253;193;60
SORRISO;43;255;1333;387;304;83
SORRISO;43;256;1333;392;289;103
SORRISO;43;257;1333;392;313;79
SORRISO;43;258;1333;364;291;73
SORRISO;43;259;1341;299;233;66
SORRISO;43;260;1341;302;220;82
SORRISO;43;261;1341;290;236;54
SORRISO;43;262;1341;304;230;74
SORRISO;43;263;1341;302;237;65
SORRISO;43;264;1341;287;211;76
SORRISO;43;265;1414;395;322;73
SORRISO;43;266;1414;382;301;81
SORRISO;43;267;1414;396;316;80
SORRISO;43;268;1414;389;277;112
SORRISO;43;269;1414;383;302;81
SORRISO;43;270;1414;386;295;91
SORRISO;43;271;1414;372;265;107
SORRISO;43;272;1368;409;300;109
SORRISO;43;273;1368;405;294;111
SORRISO;43;274;1368;400;287;113
SORRISO;43;275;1368;403;284;119
SORRISO;43;276;1368;403;296;107
SORRISO;43;277;1368;415;282;133
SORRISO;43;278;1376;390;295;95
SORRISO;43;279;1376;376;288;88
SORRISO;43;280;1376;377;281;96
SORRISO;43;281;1376;388;277;111
SORRISO;43;282;1376;382;289;93
SORRISO;43;283;1376;377;272;105
SORRISO;43;284;1376;372;273;99
SORRISO;43;285;1376;346;221;125
SORRISO;43;286;1384;424;299;125
SORRISO;43;287;1384;424;337;87
SORRISO;43;288;1384;438;312;126
SORRISO;43;289;1384;392;297;95
SORRISO;43;290;1392;245;181;64
SORRISO;43;291;1392;246;185;61
SORRISO;43;292;1392;242;185;57
SORRISO;43;293;1392;249;196;53
SORRISO;43;294;1392;240;186;54
SORRISO;43;295;1392;241;190;51
SORRISO;43;296;1392;242;184;58
SORRISO;43;297;1392;238;187;51
SORRISO;43;298;1392;242;179;63
SORRISO;43;299;1392;251;181;70
SORRISO;43;300;1392;236;185;51
SORRISO;43;301;1392;249;180;69
SORRISO;43;302;1392;231;173;58
SORRISO;43;302;1392;230;173;57
SORRISO;43;304;1406;405;278;127
SORRISO;43;305;1406;392;305;87
SORRISO;43;306;1406;393;280;113
SORRISO;43;307;1414;369;256;113
SORRISO;43;308;1430;385;301;84
SORRISO;43;309;1422;389;285;104
SORRISO;43;310;1376;354;266;88
SORRISO;43;311;1309;395;321;74
SORRISO;43;312;1040;390;301;89
SORRISO;43;313;1252;393;317;76
SORRISO;43;314;1309;398;315;83
SORRISO;43;315;1430;386;312;74
SORRISO;43;316;1309;399;305;94
SORRISO;43;317;1295;396;293;103
SORRISO;43;318;1210;392;282;110
SORRISO;43;319;1430;381;265;116
SORRISO;43;320;1368;389;235;154
SORRISO;43;321;1309;439;322;117
SORRISO;43;321;1309;438;321;117
SORRISO;43;322;1201;361;258;103
SORRISO;43;323;1414;375;237;138
SORRISO;43;324;1309;397;303;94
SORRISO;43;325;1430;388;293;95
IPIRANGA DO NORTE;43;326;1023;375;320;55
IPIRANGA DO NORTE;43;327;1015;371;296;75
IPIRANGA DO NORTE;43;328;1023;378;321;57
IPIRANGA DO NORTE;43;329;1015;299;248;51
IPIRANGA DO NORTE;43;330;1023;312;250;62
NOVA UBIRATÃ;43;331;1015;393;279;114
SORRISO;43;332;1449;153;130;23
SORRISO;43;333;1309;399;322;77
SORRISO;43;334;1295;396;331;65
SORRISO;43;335;1457;306;251;55
SORRISO;43;335;1457;305;250;55
NOVA UBIRATÃ;43;336;1015;396;327;69
SORRISO;43;337;1309;399;340;59
SORRISO;43;338;1368;233;200;33
SORRISO;43;339;1040;206;175;31
GUARANTÃ DO NORTE;44;189;1023;335;268;67
GUARANTÃ DO NORTE;44;190;1023;174;134;40
GUARANTÃ DO NORTE;44;192;1023;336;280;56
GUARANTÃ DO NORTE;44;194;1023;331;270;61
GUARANTÃ DO NORTE;44;196;1031;198;134;64
GUARANTÃ DO NORTE;44;198;1040;250;197;53
GUARANTÃ DO NORTE;44;201;1058;362;250;112
GUARANTÃ DO NORTE;44;202;1058;379;272;107
GUARANTÃ DO NORTE;44;203;1058;369;252;117
GUARANTÃ DO NORTE;44;204;1058;368;267;101
GUARANTÃ DO NORTE;44;205;1058;370;249;121
GUARANTÃ DO NORTE;44;206;1058;379;264;115
GUARANTÃ DO NORTE;44;207;1058;376;265;111
GUARANTÃ DO NORTE;44;208;1058;361;258;103
GUARANTÃ DO NORTE;44;209;1058;371;236;135
GUARANTÃ DO NORTE;44;210;1058;360;277;83
GUARANTÃ DO NORTE;44;211;1058;348;259;89
GUARANTÃ DO NORTE;44;212;1058;362;255;107
GUARANTÃ DO NORTE;44;213;1058;366;271;95
GUARANTÃ DO NORTE;44;214;1058;357;263;94
GUARANTÃ DO NORTE;44;215;1082;355;238;117
GUARANTÃ DO NORTE;44;216;1082;346;243;103
GUARANTÃ DO NORTE;44;217;1082;333;249;84
GUARANTÃ DO NORTE;44;218;1082;339;252;87
GUARANTÃ DO NORTE;44;219;1082;333;243;90
GUARANTÃ DO NORTE;44;220;1082;342;247;95
GUARANTÃ DO NORTE;44;221;1082;340;222;118
GUARANTÃ DO NORTE;44;222;1082;335;257;78
GUARANTÃ DO NORTE;44;223;1082;334;248;86
GUARANTÃ DO NORTE;44;224;1082;337;238;99
GUARANTÃ DO NORTE;44;225;1082;340;251;89
GUARANTÃ DO NORTE;44;226;1082;340;241;99
GUARANTÃ DO NORTE;44;227;1082;336;241;95
GUARANTÃ DO NORTE;44;229;1104;418;311;107
GUARANTÃ DO NORTE;44;230;1120;420;306;114
GUARANTÃ DO NORTE;44;231;1139;332;233;99
GUARANTÃ DO NORTE;44;233;1139;334;249;85
GUARANTÃ DO NORTE;44;235;1139;338;243;95
GUARANTÃ DO NORTE;44;237;1139;321;230;91
GUARANTÃ DO NORTE;44;239;1139;463;331;132
GUARANTÃ DO NORTE;44;241;1147;276;208;68
GUARANTÃ DO NORTE;44;242;1147;268;202;66
GUARANTÃ DO NORTE;44;243;1147;271;201;70
GUARANTÃ DO NORTE;44;244;1147;279;198;81
GUARANTÃ DO NORTE;44;245;1147;278;209;69
GUARANTÃ DO NORTE;44;246;1147;270;189;81
NOVO MUNDO;44;247;1023;343;253;90
NOVO MUNDO;44;248;1023;345;258;87
NOVO MUNDO;44;249;1023;346;261;85
NOVO MUNDO;44;250;1023;345;256;89
NOVO MUNDO;44;251;1023;345;249;96
NOVO MUNDO;44;252;1023;348;243;105
NOVO MUNDO;44;253;1023;346;253;93
NOVO MUNDO;44;254;1023;345;249;96
NOVO MUNDO;44;255;1023;344;272;72
NOVO MUNDO;44;256;1023;347;257;90
NOVO MUNDO;44;257;1023;349;272;77
NOVO MUNDO;44;258;1023;346;258;88
NOVO MUNDO;44;259;1031;278;192;86
NOVO MUNDO;44;260;1031;277;192;85
NOVO MUNDO;44;261;1031;276;183;93
NOVO MUNDO;44;262;1040;291;231;60
GUARANTÃ DO NORTE;44;264;1147;277;204;73
GUARANTÃ DO NORTE;44;265;1155;434;322;112
GUARANTÃ DO NORTE;44;266;1163;371;254;117
GUARANTÃ DO NORTE;44;267;1147;262;182;80
GUARANTÃ DO NORTE;44;268;1147;277;195;82
GUARANTÃ DO NORTE;44;269;1147;288;196;92
GUARANTÃ DO NORTE;44;270;1163;368;250;118
GUARANTÃ DO NORTE;44;271;1155;451;327;124
GUARANTÃ DO NORTE;44;272;1163;364;249;115
GUARANTÃ DO NORTE;44;273;1155;443;312;131
GUARANTÃ DO NORTE;44;274;1163;367;260;107
GUARANTÃ DO NORTE;44;276;1155;440;340;100
GUARANTÃ DO NORTE;44;277;1163;378;266;112
GUARANTÃ DO NORTE;44;278;1155;438;333;105
GUARANTÃ DO NORTE;44;279;1163;396;244;152
GUARANTÃ DO NORTE;44;280;1155;491;338;153
GUARANTÃ DO NORTE;44;281;1155;391;305;86
GUARANTÃ DO NORTE;44;282;1163;311;209;102
GUARANTÃ DO NORTE;44;284;1171;119;100;19
GUARANTÃ DO NORTE;44;286;1155;306;253;53
ALTO GARÇAS;45;164;1015;240;182;58
ALTO GARÇAS;45;165;1015;241;182;59
ALTO GARÇAS;45;166;1015;244;173;71
ALTO GARÇAS;45;167;1015;249;180;69
ALTO GARÇAS;45;168;1015;239;183;56
ALTO GARÇAS;45;169;1015;250;188;62
ALTO GARÇAS;45;170;1015;242;186;56
ALTO GARÇAS;45;171;1015;249;177;72
ALTO GARÇAS;45;172;1015;251;172;79
ALTO GARÇAS;45;173;1015;245;177;68
ALTO GARÇAS;45;174;1015;248;184;64
ALTO GARÇAS;45;175;1015;246;168;78
ALTO GARÇAS;45;176;1015;252;170;82
ALTO GARÇAS;45;177;1023;264;207;57
ALTO GARÇAS;45;178;1023;268;198;70
ALTO GARÇAS;45;179;1023;270;211;59
ALTO GARÇAS;45;180;1023;259;200;59
ALTO GARÇAS;45;181;1023;256;201;55
ALTO GARÇAS;45;182;1023;261;200;61
ALTO GARÇAS;45;183;1023;273;190;83
ALTO GARÇAS;45;184;1023;272;191;81
ALTO GARÇAS;45;185;1023;254;203;51
ALTO GARÇAS;45;186;1023;258;195;63
ALTO GARÇAS;45;187;1023;298;232;66
PEDRA PRETA;45;188;1015;356;252;104
PEDRA PRETA;45;189;1015;361;253;108
PEDRA PRETA;45;190;1015;366;280;86
PEDRA PRETA;45;191;1015;356;269;87
PEDRA PRETA;45;192;1015;365;278;87
PEDRA PRETA;45;193;1015;351;277;74
PEDRA PRETA;45;194;1015;371;251;120
PEDRA PRETA;45;195;1015;347;271;76
PEDRA PRETA;45;196;1015;349;279;70
PEDRA PRETA;45;197;1023;380;294;86
PEDRA PRETA;45;198;1023;379;295;84
PEDRA PRETA;45;199;1023;373;298;75
PEDRA PRETA;45;200;1023;384;293;91
PEDRA PRETA;45;201;1023;374;297;77
PEDRA PRETA;45;202;1023;371;303;68
PEDRA PRETA;45;203;1023;370;286;84
PEDRA PRETA;45;204;1023;382;301;81
PEDRA PRETA;45;205;1023;386;278;108
PEDRA PRETA;45;206;1031;335;257;78
PEDRA PRETA;45;207;1031;332;270;62
PEDRA PRETA;45;208;1031;328;263;65
PEDRA PRETA;45;209;1031;332;272;60
PEDRA PRETA;45;210;1040;296;222;74
PEDRA PRETA;45;211;1040;303;228;75
PEDRA PRETA;45;212;1040;305;226;79
PEDRA PRETA;45;213;1040;297;224;73
PEDRA PRETA;45;214;1040;308;224;84
PEDRA PRETA;45;215;1058;347;250;97
PEDRA PRETA;45;216;1058;346;259;87
PEDRA PRETA;45;217;1058;344;257;87
PEDRA PRETA;45;218;1058;337;271;66
PEDRA PRETA;45;219;1058;350;265;85
PEDRA PRETA;45;220;1066;235;180;55
PEDRA PRETA;45;223;1104;325;227;98
PEDRA PRETA;45;224;1104;329;225;104
PEDRA PRETA;45;225;1104;346;218;128
PEDRA PRETA;45;226;1112;273;186;87
PEDRA PRETA;45;227;1139;192;130;62
PEDRA PRETA;45;228;1139;329;227;102
PEDRA PRETA;45;229;1139;356;276;80
PEDRA PRETA;45;230;1031;307;232;75
PEDRA PRETA;45;231;1023;345;251;94
PEDRA PRETA;45;231;1023;344;250;94
ALTO GARÇAS;45;232;1015;331;267;64
ALTO GARÇAS;45;233;1015;320;276;44
ALTO GARÇAS;45;234;1023;325;268;57
ALTO GARÇAS;45;235;1015;306;241;65
ALTO GARÇAS;45;236;1015;315;246;69
ALTO GARÇAS;45;237;1015;310;214;96
ALTO GARÇAS;45;238;1015;217;151;66
RONDONÓPOLIS;46;13;1023;314;247;67
RONDONÓPOLIS;46;14;1023;308;240;68
RONDONÓPOLIS;46;15;1023;309;240;69
RONDONÓPOLIS;46;16;1023;311;254;57
RONDONÓPOLIS;46;17;1023;313;235;78
RONDONÓPOLIS;46;18;1023;313;237;76
RONDONÓPOLIS;46;19;1023;308;237;71
RONDONÓPOLIS;46;20;1023;307;225;82
RONDONÓPOLIS;46;21;1023;313;247;66
RONDONÓPOLIS;46;22;1023;305;246;59
RONDONÓPOLIS;46;23;1031;398;289;109
RONDONÓPOLIS;46;24;1031;392;292;100
RONDONÓPOLIS;46;25;1031;400;297;103
RONDONÓPOLIS;46;26;1031;391;287;104
RONDONÓPOLIS;46;27;1031;390;290;100
RONDONÓPOLIS;46;28;1031;394;291;103
RONDONÓPOLIS;46;29;1031;397;299;98
RONDONÓPOLIS;46;30;1040;389;281;108
RONDONÓPOLIS;46;31;1040;390;291;99
RONDONÓPOLIS;46;32;1040;394;298;96
RONDONÓPOLIS;46;33;1040;392;287;105
RONDONÓPOLIS;46;34;1040;386;301;85
RONDONÓPOLIS;46;35;1040;394;305;89
RONDONÓPOLIS;46;36;1040;389;305;84
RONDONÓPOLIS;46;48;1104;278;242;36
RONDONÓPOLIS;46;49;1104;278;224;54
RONDONÓPOLIS;46;50;1104;269;216;53
RONDONÓPOLIS;46;51;1104;256;211;45
RONDONÓPOLIS;46;52;1104;263;214;49
RONDONÓPOLIS;46;53;1112;293;234;59
RONDONÓPOLIS;46;54;1120;291;232;59
RONDONÓPOLIS;46;55;1120;298;247;51
RONDONÓPOLIS;46;56;1120;291;249;42
RONDONÓPOLIS;46;57;1120;286;235;51
RONDONÓPOLIS;46;58;1120;286;240;46
RONDONÓPOLIS;46;59;1120;290;245;45
RONDONÓPOLIS;46;60;1139;395;312;83
RONDONÓPOLIS;46;61;1139;410;313;97
RONDONÓPOLIS;46;62;1139;392;303;89
RONDONÓPOLIS;46;63;1139;390;303;87
RONDONÓPOLIS;46;64;1139;391;318;73
RONDONÓPOLIS;46;65;1139;391;310;81
RONDONÓPOLIS;46;70;1155;365;268;97
RONDONÓPOLIS;46;73;1023;311;261;50
RONDONÓPOLIS;46;74;1031;394;295;99
RONDONÓPOLIS;46;78;1023;308;244;64
RONDONÓPOLIS;46;79;1031;394;311;83
RONDONÓPOLIS;46;80;1040;387;321;66
RONDONÓPOLIS;46;81;1228;396;303;93
RONDONÓPOLIS;46;86;1139;393;322;71
RONDONÓPOLIS;46;89;1201;298;240;58
RONDONÓPOLIS;46;92;1023;302;248;54
RONDONÓPOLIS;46;94;1023;308;237;71
RONDONÓPOLIS;46;96;1228;385;309;76
RONDONÓPOLIS;46;98;1155;358;279;79
RONDONÓPOLIS;46;99;1201;281;233;48
RONDONÓPOLIS;46;100;1023;309;253;56
RONDONÓPOLIS;46;102;1228;386;289;97
RONDONÓPOLIS;46;103;1023;309;245;64
RONDONÓPOLIS;46;105;1040;391;312;79
RONDONÓPOLIS;46;106;1201;273;229;44
RONDONÓPOLIS;46;107;1228;379;297;82
RONDONÓPOLIS;46;108;1023;309;240;69
RONDONÓPOLIS;46;110;1040;380;289;91
RONDONÓPOLIS;46;111;1201;273;228;45
RONDONÓPOLIS;46;114;1023;308;247;61
RONDONÓPOLIS;46;117;1228;389;295;94
RONDONÓPOLIS;46;118;1139;388;309;79
RONDONÓPOLIS;46;123;1023;305;230;75
RONDONÓPOLIS;46;124;1201;283;234;49
RONDONÓPOLIS;46;125;1031;394;304;90
RONDONÓPOLIS;46;126;1120;291;234;57
RONDONÓPOLIS;46;129;1040;385;299;86
RONDONÓPOLIS;46;130;1112;287;227;60
RONDONÓPOLIS;46;132;1139;390;310;80
RONDONÓPOLIS;46;134;1155;359;267;92
RONDONÓPOLIS;46;135;1104;252;190;62
RONDONÓPOLIS;46;178;1252;342;268;74
RONDONÓPOLIS;46;179;1236;335;262;73
RONDONÓPOLIS;46;180;1260;383;293;90
RONDONÓPOLIS;46;181;1228;389;294;95
RONDONÓPOLIS;46;183;1139;393;308;85
RONDONÓPOLIS;46;184;1201;247;201;46
RONDONÓPOLIS;46;185;1040;391;310;81
RONDONÓPOLIS;46;186;1120;289;230;59
RONDONÓPOLIS;46;192;1120;288;202;86
RONDONÓPOLIS;46;193;1112;288;223;65
RONDONÓPOLIS;46;195;1201;294;238;56
RONDONÓPOLIS;46;198;1104;296;231;65
RONDONÓPOLIS;46;199;1236;354;279;75
RONDONÓPOLIS;46;200;1120;298;219;79
RONDONÓPOLIS;46;203;1252;346;270;76
RONDONÓPOLIS;46;204;1201;310;257;53
RONDONÓPOLIS;46;205;1236;356;286;70
RONDONÓPOLIS;46;208;1120;285;226;59
RONDONÓPOLIS;46;212;1201;313;261;52
RONDONÓPOLIS;46;216;1252;349;266;83
RONDONÓPOLIS;46;218;1236;335;236;99
RONDONÓPOLIS;46;219;1201;296;243;53
RONDONÓPOLIS;46;220;1104;242;195;47
RONDONÓPOLIS;46;225;1201;161;118;43
RONDONÓPOLIS;46;228;1287;326;259;67
RONDONÓPOLIS;46;229;1287;322;268;54
RONDONÓPOLIS;46;230;1287;322;247;75
RONDONÓPOLIS;46;231;1287;319;224;95
RONDONÓPOLIS;46;232;1260;385;272;113
RONDONÓPOLIS;46;233;1236;336;266;70
RONDONÓPOLIS;46;234;1295;357;279;78
RONDONÓPOLIS;46;235;1295;360;281;79
RONDONÓPOLIS;46;236;1295;359;277;82
RONDONÓPOLIS;46;237;1295;358;272;86
RONDONÓPOLIS;46;238;1295;358;279;79
RONDONÓPOLIS;46;239;1295;362;286;76
RONDONÓPOLIS;46;240;1295;363;285;78
RONDONÓPOLIS;46;241;1295;362;279;83
RONDONÓPOLIS;46;242;1295;360;292;68
RONDONÓPOLIS;46;243;1295;357;287;70
RONDONÓPOLIS;46;244;1295;366;288;78
RONDONÓPOLIS;46;245;1295;366;288;78
RONDONÓPOLIS;46;246;1295;357;283;74
RONDONÓPOLIS;46;247;1295;359;283;76
RONDONÓPOLIS;46;248;1295;353;280;73
RONDONÓPOLIS;46;249;1309;343;266;77
RONDONÓPOLIS;46;250;1309;340;270;70
RONDONÓPOLIS;46;251;1309;344;273;71
RONDONÓPOLIS;46;252;1309;347;274;73
RONDONÓPOLIS;46;253;1309;344;268;76
RONDONÓPOLIS;46;254;1309;349;265;84
RONDONÓPOLIS;46;255;1309;348;257;91
RONDONÓPOLIS;46;256;1309;345;273;72
RONDONÓPOLIS;46;257;1309;349;267;82
RONDONÓPOLIS;46;258;1309;344;265;79
RONDONÓPOLIS;46;259;1309;341;264;77
RONDONÓPOLIS;46;260;1309;345;266;79
RONDONÓPOLIS;46;261;1309;344;261;83
RONDONÓPOLIS;46;262;1309;348;273;75
RONDONÓPOLIS;46;263;1309;337;265;72
RONDONÓPOLIS;46;264;1309;354;289;65
RONDONÓPOLIS;46;265;1309;348;249;99
RONDONÓPOLIS;46;266;1317;312;259;53
RONDONÓPOLIS;46;268;1325;340;283;57
RONDONÓPOLIS;46;269;1325;337;274;63
RONDONÓPOLIS;46;270;1325;333;264;69
RONDONÓPOLIS;46;271;1325;332;256;76
RONDONÓPOLIS;46;272;1325;332;236;96
RONDONÓPOLIS;46;273;1333;308;247;61
RONDONÓPOLIS;46;274;1333;307;236;71
RONDONÓPOLIS;46;275;1333;304;243;61
RONDONÓPOLIS;46;276;1333;309;235;74
RONDONÓPOLIS;46;277;1333;306;235;71
RONDONÓPOLIS;46;278;1333;309;253;56
RONDONÓPOLIS;46;279;1333;310;248;62
RONDONÓPOLIS;46;280;1333;304;236;68
RONDONÓPOLIS;46;281;1333;306;248;58
RONDONÓPOLIS;46;282;1333;306;234;72
RONDONÓPOLIS;46;283;1333;303;240;63
RONDONÓPOLIS;46;284;1333;301;247;54
RONDONÓPOLIS;46;285;1333;299;240;59
RONDONÓPOLIS;46;286;1333;306;246;60
RONDONÓPOLIS;46;287;1341;317;262;55
RONDONÓPOLIS;46;287;1341;316;261;55
RONDONÓPOLIS;46;288;1341;319;227;92
RONDONÓPOLIS;46;289;1341;313;253;60
RONDONÓPOLIS;46;290;1341;313;231;82
RONDONÓPOLIS;46;291;1341;316;244;72
RONDONÓPOLIS;46;292;1341;312;245;67
RONDONÓPOLIS;46;293;1341;316;242;74
RONDONÓPOLIS;46;294;1341;314;256;58
RONDONÓPOLIS;46;295;1341;306;232;74
RONDONÓPOLIS;46;296;1341;316;261;55
RONDONÓPOLIS;46;297;1341;312;245;67
RONDONÓPOLIS;46;298;1341;319;241;78
RONDONÓPOLIS;46;299;1457;378;275;103
RONDONÓPOLIS;46;300;1368;316;258;58
RONDONÓPOLIS;46;302;1376;381;304;77
RONDONÓPOLIS;46;303;1376;380;316;64
RONDONÓPOLIS;46;304;1376;378;315;63
RONDONÓPOLIS;46;305;1376;377;309;68
RONDONÓPOLIS;46;306;1384;396;281;115
RONDONÓPOLIS;46;307;1392;389;291;98
RONDONÓPOLIS;46;308;1392;389;287;102
RONDONÓPOLIS;46;309;1392;386;301;85
RONDONÓPOLIS;46;310;1392;389;294;95
RONDONÓPOLIS;46;311;1392;390;307;83
RONDONÓPOLIS;46;312;1392;389;312;77
RONDONÓPOLIS;46;313;1392;389;312;77
RONDONÓPOLIS;46;314;1392;391;290;101
RONDONÓPOLIS;46;315;1392;387;263;124
RONDONÓPOLIS;46;316;1406;387;272;115
RONDONÓPOLIS;46;316;1406;386;271;115
RONDONÓPOLIS;46;317;1414;397;299;98
RONDONÓPOLIS;46;318;1414;392;285;107
RONDONÓPOLIS;46;319;1414;390;296;94
RONDONÓPOLIS;46;320;1414;401;283;118
RONDONÓPOLIS;46;321;1260;147;109;38
RONDONÓPOLIS;46;322;1430;347;270;77
RONDONÓPOLIS;46;323;1430;351;273;78
RONDONÓPOLIS;46;324;1430;350;288;62
RONDONÓPOLIS;46;325;1430;337;262;75
RONDONÓPOLIS;46;326;1430;352;274;78
RONDONÓPOLIS;46;327;1430;346;267;79
RONDONÓPOLIS;46;328;1430;342;271;71
RONDONÓPOLIS;46;329;1430;340;258;82
RONDONÓPOLIS;46;330;1430;341;272;69
RONDONÓPOLIS;46;331;1430;344;268;76
RONDONÓPOLIS;46;332;1430;343;254;89
RONDONÓPOLIS;46;333;1449;382;304;78
RONDONÓPOLIS;46;334;1449;367;286;81
RONDONÓPOLIS;46;335;1449;380;292;88
RONDONÓPOLIS;46;336;1449;374;283;91
RONDONÓPOLIS;46;337;1449;383;295;88
RONDONÓPOLIS;46;338;1449;381;302;79
RONDONÓPOLIS;46;339;1449;372;290;82
RONDONÓPOLIS;46;340;1449;381;304;77
RONDONÓPOLIS;46;341;1449;370;297;73
RONDONÓPOLIS;46;342;1449;372;275;97
RONDONÓPOLIS;46;343;1449;371;278;93
RONDONÓPOLIS;46;344;1449;371;288;83
RONDONÓPOLIS;46;345;1449;366;284;82
RONDONÓPOLIS;46;346;1449;372;253;119
RONDONÓPOLIS;46;347;1449;374;257;117
RONDONÓPOLIS;46;348;1457;378;269;109
RONDONÓPOLIS;46;350;1457;376;282;94
RONDONÓPOLIS;46;351;1457;377;265;112
RONDONÓPOLIS;46;352;1457;376;254;122
RONDONÓPOLIS;46;353;1465;388;288;100
RONDONÓPOLIS;46;354;1465;385;303;82
RONDONÓPOLIS;46;355;1465;386;300;86
RONDONÓPOLIS;46;356;1465;386;321;65
RONDONÓPOLIS;46;357;1465;384;295;89
RONDONÓPOLIS;46;358;1465;382;299;83
RONDONÓPOLIS;46;359;1465;384;305;79
RONDONÓPOLIS;46;360;1465;379;291;88
RONDONÓPOLIS;46;361;1465;390;285;105
RONDONÓPOLIS;46;362;1465;378;288;90
RONDONÓPOLIS;46;363;1465;386;284;102
RONDONÓPOLIS;46;365;1481;259;201;58
RONDONÓPOLIS;46;366;1481;262;222;40
RONDONÓPOLIS;46;367;1481;260;209;51
RONDONÓPOLIS;46;368;1481;262;219;43
RONDONÓPOLIS;46;369;1481;264;219;45
RONDONÓPOLIS;46;370;1481;260;198;62
RONDONÓPOLIS;46;371;1481;262;210;52
RONDONÓPOLIS;46;372;1481;263;201;62
RONDONÓPOLIS;46;373;1481;261;195;66
RONDONÓPOLIS;46;374;1481;263;204;59
RONDONÓPOLIS;46;375;1481;261;215;46
RONDONÓPOLIS;46;376;1481;261;205;56
RONDONÓPOLIS;46;377;1481;262;214;48
RONDONÓPOLIS;46;378;1481;258;226;32
RONDONÓPOLIS;46;379;1325;336;237;99
RONDONÓPOLIS;46;379;1325;335;236;99
RONDONÓPOLIS;46;380;1503;306;219;87
RONDONÓPOLIS;46;381;1511;385;291;94
RONDONÓPOLIS;46;383;1520;383;299;84
RONDONÓPOLIS;46;384;1520;383;305;78
RONDONÓPOLIS;46;385;1520;385;312;73
RONDONÓPOLIS;46;386;1520;388;306;82
RONDONÓPOLIS;46;387;1040;391;251;140
RONDONÓPOLIS;46;388;1449;366;274;92
RONDONÓPOLIS;46;389;1384;392;324;68
RONDONÓPOLIS;46;390;1406;398;302;96
RONDONÓPOLIS;46;391;1392;392;315;77
RONDONÓPOLIS;46;392;1449;282;211;71
RONDONÓPOLIS;46;393;1589;335;293;42
RONDONÓPOLIS;46;394;1597;288;234;54
RONDONÓPOLIS;46;395;1465;383;320;63
RONDONÓPOLIS;46;396;1392;394;329;65
RONDONÓPOLIS;46;397;1260;317;269;48
RONDONÓPOLIS;46;397;1260;178;152;26
RONDONÓPOLIS;46;398;1228;122;96;26
RONDONÓPOLIS;46;399;1406;129;107;22
RONDONÓPOLIS;46;400;1384;79;66;13
POXORÉU;47;175;1015;295;209;86
POXORÉU;47;176;1015;299;213;86
POXORÉU;47;177;1015;290;203;87
POXORÉU;47;178;1015;303;213;90
POXORÉU;47;179;1015;285;215;70
POXORÉU;47;180;1015;301;212;89
POXORÉU;47;181;1015;286;214;72
POXORÉU;47;182;1023;341;229;112
POXORÉU;47;183;1023;349;236;113
POXORÉU;47;184;1023;341;244;97
POXORÉU;47;185;1023;339;234;105
POXORÉU;47;186;1023;348;234;114
POXORÉU;47;187;1031;244;184;60
POXORÉU;47;188;1031;241;178;63
POXORÉU;47;189;1031;242;184;58
POXORÉU;47;190;1031;245;164;81
POXORÉU;47;191;1031;245;184;61
POXORÉU;47;192;1040;261;158;103
POXORÉU;47;194;1040;262;162;100
POXORÉU;47;196;1040;248;170;78
POXORÉU;47;198;1040;239;170;69
POXORÉU;47;200;1040;137;100;37
POXORÉU;47;201;1074;252;152;100
POXORÉU;47;202;1074;251;154;97
POXORÉU;47;203;1074;259;155;104
POXORÉU;47;204;1074;248;154;94
POXORÉU;47;205;1082;141;101;40
POXORÉU;47;206;1082;281;202;79
POXORÉU;47;208;1090;295;179;116
POXORÉU;47;210;1090;296;191;105
POXORÉU;47;212;1090;280;192;88
POXORÉU;47;214;1112;386;256;130
POXORÉU;47;216;1120;378;203;175
POXORÉU;47;217;1120;268;182;86
POXORÉU;47;218;1120;260;185;75
POXORÉU;47;219;1120;272;180;92
POXORÉU;47;220;1120;267;182;85
POXORÉU;47;221;1147;342;254;88
POXORÉU;47;222;1147;345;259;86
POXORÉU;47;223;1147;321;241;80
POXORÉU;47;224;1147;336;251;85
POXORÉU;47;227;1180;360;236;124
POXORÉU;47;228;1198;258;192;66
POXORÉU;47;229;1201;355;217;138
POXORÉU;47;231;1228;242;189;53
POXORÉU;47;236;1252;353;251;102
POXORÉU;47;237;1252;346;248;98
POXORÉU;47;239;1180;114;74;40
POXORÉU;47;240;1023;278;199;79
POXORÉU;47;241;1147;197;150;47
POXORÉU;47;242;1295;319;246;73
COTRIGUAÇU;48;86;1015;314;225;89
COTRIGUAÇU;48;87;1015;307;215;92
COTRIGUAÇU;48;88;1015;311;227;84
COTRIGUAÇU;48;89;1015;307;216;91
COTRIGUAÇU;48;90;1015;308;222;86
COTRIGUAÇU;48;91;1015;308;244;64
COTRIGUAÇU;48;92;1015;307;216;91
COTRIGUAÇU;48;93;1023;349;275;74
COTRIGUAÇU;48;95;1040;135;116;19
COTRIGUAÇU;48;96;1023;347;270;77
COTRIGUAÇU;48;98;1074;80;64;16
COTRIGUAÇU;48;100;1082;188;130;58
COTRIGUAÇU;48;101;1252;373;294;79
COTRIGUAÇU;48;102;1252;201;145;56
COTRIGUAÇU;48;104;1228;315;222;93
COTRIGUAÇU;48;106;1287;169;122;47
COTRIGUAÇU;48;107;1244;376;263;113
COTRIGUAÇU;48;109;1244;370;269;101
COTRIGUAÇU;48;110;1147;293;217;76
COTRIGUAÇU;48;111;1147;296;207;89
COTRIGUAÇU;48;112;1147;299;205;94
COTRIGUAÇU;48;113;1147;290;193;97
COTRIGUAÇU;48;113;1147;288;191;97
COTRIGUAÇU;48;114;1147;303;204;99
JURUENA;48;115;1104;300;233;67
JURUENA;48;117;1104;297;230;67
JURUENA;48;119;1104;297;240;57
JURUENA;48;121;1104;295;240;55
JURUENA;48;123;1104;291;229;62
JURUENA;48;125;1090;276;199;77
JURUENA;48;126;1090;277;188;89
JURUENA;48;127;1031;323;220;103
JURUENA;48;128;1031;329;226;103
JURUENA;48;129;1031;329;229;100
JURUENA;48;130;1031;332;237;95
COTRIGUAÇU;48;131;1228;271;177;94
JURUENA;48;132;1031;323;214;109
JURUENA;48;133;1031;322;209;113
JURUENA;48;134;1082;284;206;78
JURUENA;48;135;1090;279;189;90
JURUENA;48;138;1031;335;230;105
JURUENA;48;139;1066;305;233;72
COTRIGUAÇU;48;141;1252;373;288;85
COTRIGUAÇU;48;142;1252;374;276;98
COTRIGUAÇU;48;143;1228;221;170;51
JURUENA;48;145;1090;277;206;71
COTRIGUAÇU;48;150;1228;223;168;55
COTRIGUAÇU;48;152;1082;233;184;49
JURUENA;48;153;1090;278;191;87
JURUENA;48;154;1031;338;214;124
COTRIGUAÇU;48;156;1147;267;177;90
JURUENA;48;158;1031;234;188;46
VÁRZEA GRANDE;49;1;1015;328;275;53
VÁRZEA GRANDE;49;2;1015;328;276;52
VÁRZEA GRANDE;49;3;1015;324;265;59
VÁRZEA GRANDE;49;4;1015;323;265;58
VÁRZEA GRANDE;49;5;1015;325;273;52
VÁRZEA GRANDE;49;6;1015;324;271;53
VÁRZEA GRANDE;49;7;1015;329;269;60
VÁRZEA GRANDE;49;8;1015;325;272;53
VÁRZEA GRANDE;49;9;1015;327;270;57
VÁRZEA GRANDE;49;10;1015;318;269;49
VÁRZEA GRANDE;49;11;1015;323;259;64
VÁRZEA GRANDE;49;12;1015;327;271;56
VÁRZEA GRANDE;49;13;1015;321;273;48
VÁRZEA GRANDE;49;14;1023;308;232;76
VÁRZEA GRANDE;49;15;1023;304;240;64
VÁRZEA GRANDE;49;16;1023;303;241;62
VÁRZEA GRANDE;49;17;1023;305;255;50
VÁRZEA GRANDE;49;18;1023;305;233;72
VÁRZEA GRANDE;49;19;1058;341;272;69
VÁRZEA GRANDE;49;20;1058;337;279;58
VÁRZEA GRANDE;49;21;1058;341;265;76
VÁRZEA GRANDE;49;22;1040;358;293;65
VÁRZEA GRANDE;49;23;1040;353;273;80
VÁRZEA GRANDE;49;24;1040;357;277;80
VÁRZEA GRANDE;49;25;1040;360;293;67
VÁRZEA GRANDE;49;26;1040;350;283;67
VÁRZEA GRANDE;49;27;1040;357;289;68
VÁRZEA GRANDE;49;28;1040;354;291;63
VÁRZEA GRANDE;49;29;1058;337;275;62
VÁRZEA GRANDE;49;30;1058;341;259;82
VÁRZEA GRANDE;49;31;1058;338;272;66
VÁRZEA GRANDE;49;32;1058;337;279;58
VÁRZEA GRANDE;49;33;1058;346;287;59
VÁRZEA GRANDE;49;34;1058;340;275;65
VÁRZEA GRANDE;49;35;1058;342;274;68
VÁRZEA GRANDE;49;36;1058;341;277;64
VÁRZEA GRANDE;49;37;1058;339;281;58
VÁRZEA GRANDE;49;38;1058;340;287;53
VÁRZEA GRANDE;49;39;1317;217;189;28
VÁRZEA GRANDE;49;40;1066;419;342;77
VÁRZEA GRANDE;49;41;1066;420;346;74
VÁRZEA GRANDE;49;42;1066;417;339;78
VÁRZEA GRANDE;49;48;1074;222;184;38
VÁRZEA GRANDE;49;49;1074;225;186;39
VÁRZEA GRANDE;49;50;1074;219;190;29
VÁRZEA GRANDE;49;51;1074;220;180;40
VÁRZEA GRANDE;49;52;1074;223;185;38
VÁRZEA GRANDE;49;53;1082;341;262;79
VÁRZEA GRANDE;49;54;1082;339;272;67
VÁRZEA GRANDE;49;55;1082;336;267;69
VÁRZEA GRANDE;49;56;1090;361;305;56
VÁRZEA GRANDE;49;57;1090;356;303;53
VÁRZEA GRANDE;49;58;1090;358;296;62
VÁRZEA GRANDE;49;59;1104;341;287;54
VÁRZEA GRANDE;49;59;1104;340;286;54
VÁRZEA GRANDE;49;60;1104;335;267;68
VÁRZEA GRANDE;49;61;1104;340;267;73
VÁRZEA GRANDE;49;62;1104;339;265;74
VÁRZEA GRANDE;49;63;1104;339;261;78
VÁRZEA GRANDE;49;64;1104;338;283;55
VÁRZEA GRANDE;49;65;1104;338;276;62
VÁRZEA GRANDE;49;66;1104;338;272;66
VÁRZEA GRANDE;49;67;1325;297;250;47
VÁRZEA GRANDE;49;68;1325;289;222;67
VÁRZEA GRANDE;49;69;1325;295;237;58
VÁRZEA GRANDE;49;70;1260;230;202;28
VÁRZEA GRANDE;49;71;1260;224;184;40
VÁRZEA GRANDE;49;72;1260;228;184;44
VÁRZEA GRANDE;49;73;1260;223;178;45
VÁRZEA GRANDE;49;74;1260;224;181;43
VÁRZEA GRANDE;49;82;1171;331;285;46
VÁRZEA GRANDE;49;83;1171;329;279;50
VÁRZEA GRANDE;49;84;1171;328;277;51
VÁRZEA GRANDE;49;85;1171;327;279;48
VÁRZEA GRANDE;49;86;1260;224;180;44
VÁRZEA GRANDE;49;87;1198;362;292;70
VÁRZEA GRANDE;49;88;1201;294;254;40
VÁRZEA GRANDE;49;89;1210;306;276;30
VÁRZEA GRANDE;49;90;1228;325;291;34
VÁRZEA GRANDE;49;91;1082;337;279;58
VÁRZEA GRANDE;49;92;1244;339;280;59
VÁRZEA GRANDE;49;93;1317;211;187;24
VÁRZEA GRANDE;49;94;1082;338;289;49
VÁRZEA GRANDE;49;95;1015;326;279;47
VÁRZEA GRANDE;49;96;1317;211;178;33
VÁRZEA GRANDE;49;97;1228;325;284;41
VÁRZEA GRANDE;49;98;1244;337;285;52
VÁRZEA GRANDE;49;99;1066;417;342;75
VÁRZEA GRANDE;49;100;1090;353;290;63
VÁRZEA GRANDE;49;101;1252;356;306;50
VÁRZEA GRANDE;49;102;1015;321;269;52
VÁRZEA GRANDE;49;103;1040;355;288;67
VÁRZEA GRANDE;49;104;1074;222;187;35
VÁRZEA GRANDE;49;105;1325;286;234;52
VÁRZEA GRANDE;49;106;1317;212;183;29
VÁRZEA GRANDE;49;107;1066;417;347;70
VÁRZEA GRANDE;49;108;1023;300;240;60
VÁRZEA GRANDE;49;111;1244;338;291;47
VÁRZEA GRANDE;49;112;1228;319;269;50
VÁRZEA GRANDE;49;113;1260;226;199;27
VÁRZEA GRANDE;49;114;1023;303;243;60
VÁRZEA GRANDE;49;115;1210;305;254;51
VÁRZEA GRANDE;49;116;1201;289;246;43
VÁRZEA GRANDE;49;117;1023;301;246;55
VÁRZEA GRANDE;49;118;1090;362;300;62
VÁRZEA GRANDE;49;119;1244;339;268;71
VÁRZEA GRANDE;49;120;1171;325;280;45
VÁRZEA GRANDE;49;121;1252;354;310;44
VÁRZEA GRANDE;49;122;1260;227;189;38
VÁRZEA GRANDE;49;123;1082;339;275;64
VÁRZEA GRANDE;49;124;1066;416;324;92
VÁRZEA GRANDE;49;126;1317;208;177;31
VÁRZEA GRANDE;49;127;1023;302;242;60
VÁRZEA GRANDE;49;128;1260;222;190;32
VÁRZEA GRANDE;49;129;1228;323;282;41
VÁRZEA GRANDE;49;130;1082;339;290;49
VÁRZEA GRANDE;49;131;1244;335;277;58
VÁRZEA GRANDE;49;132;1198;352;297;55
VÁRZEA GRANDE;49;133;1090;356;287;69
VÁRZEA GRANDE;49;134;1023;300;236;64
VÁRZEA GRANDE;49;135;1074;218;188;30
VÁRZEA GRANDE;49;136;1228;320;276;44
VÁRZEA GRANDE;49;137;1295;216;189;27
VÁRZEA GRANDE;49;138;1287;283;232;51
VÁRZEA GRANDE;49;139;1295;210;183;27
VÁRZEA GRANDE;49;140;1309;344;286;58
VÁRZEA GRANDE;49;141;1317;211;185;26
VÁRZEA GRANDE;49;142;1244;337;276;61
VÁRZEA GRANDE;49;143;1325;287;251;36
VÁRZEA GRANDE;49;144;1210;301;249;52
VÁRZEA GRANDE;49;145;1295;211;172;39
VÁRZEA GRANDE;49;146;1317;207;170;37
VÁRZEA GRANDE;49;147;1082;337;270;67
VÁRZEA GRANDE;49;148;1201;281;243;38
VÁRZEA GRANDE;49;149;1333;340;309;31
VÁRZEA GRANDE;49;150;1333;342;308;34
VÁRZEA GRANDE;49;153;1341;362;309;53
VÁRZEA GRANDE;49;154;1350;263;217;46
VÁRZEA GRANDE;49;155;1350;253;206;47
VÁRZEA GRANDE;49;156;1350;251;209;42
VÁRZEA GRANDE;49;157;1350;253;217;36
VÁRZEA GRANDE;49;165;1384;365;294;71
VÁRZEA GRANDE;49;166;1384;361;283;78
VÁRZEA GRANDE;49;167;1384;364;298;66
VÁRZEA GRANDE;49;168;1384;363;308;55
VÁRZEA GRANDE;49;169;1384;352;304;48
VÁRZEA GRANDE;49;170;1384;356;294;62
VÁRZEA GRANDE;49;171;1384;361;293;68
VÁRZEA GRANDE;49;172;1384;360;297;63
VÁRZEA GRANDE;49;173;1384;357;288;69
VÁRZEA GRANDE;49;174;1384;361;289;72
VÁRZEA GRANDE;49;175;1350;254;207;47
VÁRZEA GRANDE;49;176;1350;252;204;48
VÁRZEA GRANDE;49;177;1350;251;205;46
VÁRZEA GRANDE;49;178;1406;272;211;61
VÁRZEA GRANDE;49;179;1406;273;234;39
VÁRZEA GRANDE;49;180;1406;270;212;58
VÁRZEA GRANDE;49;181;1406;270;225;45
VÁRZEA GRANDE;49;182;1406;270;219;51
VÁRZEA GRANDE;49;183;1406;271;221;50
VÁRZEA GRANDE;49;184;1406;271;219;52
VÁRZEA GRANDE;49;185;1406;268;216;52
VÁRZEA GRANDE;49;186;1406;273;231;42
VÁRZEA GRANDE;49;188;1422;361;313;48
VÁRZEA GRANDE;49;188;1422;254;216;38
VÁRZEA GRANDE;49;189;1422;360;306;54
VÁRZEA GRANDE;49;189;1422;250;213;37
VÁRZEA GRANDE;49;190;1422;383;325;58
VÁRZEA GRANDE;49;191;1430;375;308;67
VÁRZEA GRANDE;49;192;1430;372;312;60
VÁRZEA GRANDE;49;193;1430;376;312;64
VÁRZEA GRANDE;49;194;1430;372;305;67
VÁRZEA GRANDE;49;195;1430;374;315;59
VÁRZEA GRANDE;49;196;1430;375;325;50
VÁRZEA GRANDE;49;197;1430;368;307;61
VÁRZEA GRANDE;49;198;1430;373;308;65
VÁRZEA GRANDE;49;199;1430;373;306;67
VÁRZEA GRANDE;49;200;1430;374;306;68
VÁRZEA GRANDE;49;201;1457;386;308;78
VÁRZEA GRANDE;49;202;1457;375;304;71
VÁRZEA GRANDE;49;203;1457;382;301;81
VÁRZEA GRANDE;49;204;1457;380;308;72
VÁRZEA GRANDE;49;205;1457;380;313;67
VÁRZEA GRANDE;49;206;1457;384;321;63
VÁRZEA GRANDE;49;207;1457;381;308;73
VÁRZEA GRANDE;49;208;1457;386;330;56
VÁRZEA GRANDE;49;209;1465;337;287;50
VÁRZEA GRANDE;49;210;1465;336;285;51
VÁRZEA GRANDE;49;211;1465;332;272;60
VÁRZEA GRANDE;49;212;1465;333;270;63
VÁRZEA GRANDE;49;213;1295;212;178;34
VÁRZEA GRANDE;49;214;1171;328;288;40
VÁRZEA GRANDE;49;215;1090;354;283;71
VÁRZEA GRANDE;49;216;1287;292;255;37
VÁRZEA GRANDE;49;217;1457;379;309;70
VÁRZEA GRANDE;49;218;1430;372;313;59
VÁRZEA GRANDE;49;219;1244;343;280;63
VÁRZEA GRANDE;49;220;1457;377;311;66
VÁRZEA GRANDE;49;221;1104;332;283;49
VÁRZEA GRANDE;49;222;1295;213;181;32
VÁRZEA GRANDE;49;223;1325;286;233;53
VÁRZEA GRANDE;49;224;1309;346;300;46
VÁRZEA GRANDE;49;225;1082;334;265;69
VÁRZEA GRANDE;49;226;1228;320;275;45
VÁRZEA GRANDE;49;227;1430;372;312;60
VÁRZEA GRANDE;49;228;1198;364;295;69
VÁRZEA GRANDE;49;229;1384;358;281;77
VÁRZEA GRANDE;49;230;1457;376;292;84
VÁRZEA GRANDE;49;231;1090;355;297;58
VÁRZEA GRANDE;49;232;1104;338;274;64
VÁRZEA GRANDE;49;233;1058;342;253;89
VÁRZEA GRANDE;49;234;1457;383;304;79
VÁRZEA GRANDE;49;235;1473;392;306;86
VÁRZEA GRANDE;49;236;1473;395;321;74
VÁRZEA GRANDE;49;237;1473;390;326;64
VÁRZEA GRANDE;49;238;1473;391;326;65
VÁRZEA GRANDE;49;239;1473;391;310;81
VÁRZEA GRANDE;49;240;1473;394;308;86
VÁRZEA GRANDE;49;241;1473;390;305;85
VÁRZEA GRANDE;49;242;1473;389;316;73
VÁRZEA GRANDE;49;243;1473;395;316;79
VÁRZEA GRANDE;49;244;1481;270;232;38
VÁRZEA GRANDE;49;245;1481;275;230;45
VÁRZEA GRANDE;49;247;1481;266;225;41
VÁRZEA GRANDE;49;248;1481;265;228;37
VÁRZEA GRANDE;49;249;1481;272;236;36
VÁRZEA GRANDE;49;250;1490;309;247;62
VÁRZEA GRANDE;49;251;1490;305;255;50
VÁRZEA GRANDE;49;252;1490;309;262;47
VÁRZEA GRANDE;49;253;1490;307;255;52
VÁRZEA GRANDE;49;254;1503;365;307;58
VÁRZEA GRANDE;49;256;1503;374;292;82
VÁRZEA GRANDE;49;257;1503;365;288;77
VÁRZEA GRANDE;49;258;1503;370;302;68
VÁRZEA GRANDE;49;259;1503;373;289;84
VÁRZEA GRANDE;49;260;1503;374;298;76
VÁRZEA GRANDE;49;261;1511;356;285;71
VÁRZEA GRANDE;49;262;1511;356;306;50
VÁRZEA GRANDE;49;263;1511;355;284;71
VÁRZEA GRANDE;49;264;1511;352;296;56
VÁRZEA GRANDE;49;265;1511;353;295;58
VÁRZEA GRANDE;49;266;1511;359;293;66
VÁRZEA GRANDE;49;267;1520;210;178;32
VÁRZEA GRANDE;49;268;1520;205;179;26
VÁRZEA GRANDE;49;269;1520;202;178;24
VÁRZEA GRANDE;49;270;1538;317;288;29
VÁRZEA GRANDE;49;272;1546;373;336;37
VÁRZEA GRANDE;49;281;1570;361;274;87
VÁRZEA GRANDE;49;282;1570;357;260;97
VÁRZEA GRANDE;49;283;1570;358;271;87
VÁRZEA GRANDE;49;284;1570;354;277;77
VÁRZEA GRANDE;49;285;1589;345;297;48
VÁRZEA GRANDE;49;286;1589;338;278;60
VÁRZEA GRANDE;49;287;1589;337;274;63
VÁRZEA GRANDE;49;288;1589;341;283;58
VÁRZEA GRANDE;49;289;1589;340;273;67
VÁRZEA GRANDE;49;290;1589;342;272;70
VÁRZEA GRANDE;49;291;1589;342;278;64
VÁRZEA GRANDE;49;301;1635;377;328;49
VÁRZEA GRANDE;49;302;1635;378;331;47
VÁRZEA GRANDE;49;303;1635;377;327;50
VÁRZEA GRANDE;49;306;1635;377;329;48
VÁRZEA GRANDE;49;310;1635;377;325;52
VÁRZEA GRANDE;49;312;1635;377;313;64
VÁRZEA GRANDE;49;313;1635;374;321;53
VÁRZEA GRANDE;49;314;1635;383;324;59
VÁRZEA GRANDE;49;315;1643;234;196;38
VÁRZEA GRANDE;49;317;1643;339;276;63
VÁRZEA GRANDE;49;318;1643;234;202;32
VÁRZEA GRANDE;49;332;1660;348;297;51
VÁRZEA GRANDE;49;333;1660;349;294;55
VÁRZEA GRANDE;49;334;1678;286;232;54
VÁRZEA GRANDE;49;335;1694;328;283;45
VÁRZEA GRANDE;49;336;1694;364;289;75
VÁRZEA GRANDE;49;337;1708;368;287;81
VÁRZEA GRANDE;49;338;1708;371;291;80
VÁRZEA GRANDE;49;339;1708;367;288;79
VÁRZEA GRANDE;49;340;1732;200;170;30
VÁRZEA GRANDE;49;342;1740;257;220;37
VÁRZEA GRANDE;49;343;1740;251;211;40
VÁRZEA GRANDE;49;344;1740;258;219;39
VÁRZEA GRANDE;49;345;1740;250;224;26
VÁRZEA GRANDE;49;346;1759;331;268;63
VÁRZEA GRANDE;49;347;1759;335;273;62
VÁRZEA GRANDE;49;348;1759;333;255;78
VÁRZEA GRANDE;49;349;1759;327;261;66
VÁRZEA GRANDE;49;350;1660;353;268;85
VÁRZEA GRANDE;49;351;1589;345;261;84
VÁRZEA GRANDE;49;352;1694;326;250;76
VÁRZEA GRANDE;49;353;1228;330;275;55
VÁRZEA GRANDE;49;354;1287;200;175;25
VÁRZEA GRANDE;49;355;1430;371;291;80
VÁRZEA GRANDE;49;356;1708;123;92;31
NOVA MONTE VERDE;50;124;1015;189;124;65
NOVA MONTE VERDE;50;126;1023;326;243;83
NOVA MONTE VERDE;50;127;1023;328;233;95
NOVA MONTE VERDE;50;128;1023;328;233;95
NOVA MONTE VERDE;50;129;1023;322;228;94
NOVA MONTE VERDE;50;130;1023;318;244;74
NOVA MONTE VERDE;50;131;1023;319;238;81
NOVA MONTE VERDE;50;132;1031;239;166;73
NOVA MONTE VERDE;50;133;1031;225;181;44
NOVA MONTE VERDE;50;134;1023;314;252;62
NOVA MONTE VERDE;50;135;1058;319;237;82
NOVA MONTE VERDE;50;136;1058;321;225;96
NOVA MONTE VERDE;50;137;1058;319;239;80
NOVA MONTE VERDE;50;138;1058;331;226;105
NOVA MONTE VERDE;50;139;1058;316;226;90
NOVA MONTE VERDE;50;140;1058;315;249;66
NOVA MONTE VERDE;50;141;1058;322;236;86
NOVA BANDEIRANTES;50;142;1015;373;258;115
NOVA BANDEIRANTES;50;143;1015;368;256;112
NOVA BANDEIRANTES;50;144;1015;367;255;112
NOVA BANDEIRANTES;50;145;1015;368;239;129
NOVA BANDEIRANTES;50;146;1015;369;262;107
NOVA BANDEIRANTES;50;147;1015;367;271;96
NOVA BANDEIRANTES;50;148;1015;368;262;106
NOVA BANDEIRANTES;50;149;1015;372;263;109
NOVA BANDEIRANTES;50;150;1023;395;302;93
NOVA BANDEIRANTES;50;151;1023;396;299;97
NOVA BANDEIRANTES;50;152;1023;393;308;85
NOVA BANDEIRANTES;50;153;1031;287;219;68
NOVA BANDEIRANTES;50;154;1040;303;219;84
NOVA BANDEIRANTES;50;155;1040;307;213;94
NOVA BANDEIRANTES;50;156;1040;304;214;90
NOVA BANDEIRANTES;50;157;1040;305;217;88
NOVA BANDEIRANTES;50;158;1040;304;195;109
NOVA BANDEIRANTES;50;159;1040;306;205;101
NOVA BANDEIRANTES;50;160;1040;303;220;83
NOVA BANDEIRANTES;50;161;1040;304;222;82
NOVA BANDEIRANTES;50;162;1058;283;195;88
NOVA BANDEIRANTES;50;163;1066;278;211;67
NOVA BANDEIRANTES;50;164;1066;278;207;71
NOVA BANDEIRANTES;50;165;1074;225;149;76
APIACÁS;50;166;1015;271;195;76
APIACÁS;50;167;1015;272;201;71
APIACÁS;50;168;1015;271;190;81
APIACÁS;50;169;1015;271;194;77
APIACÁS;50;170;1015;273;197;76
APIACÁS;50;171;1015;273;194;79
APIACÁS;50;172;1015;274;190;84
APIACÁS;50;173;1066;252;203;49
APIACÁS;50;174;1066;253;196;57
APIACÁS;50;175;1066;250;197;53
APIACÁS;50;176;1066;251;190;61
APIACÁS;50;177;1066;253;192;61
APIACÁS;50;178;1066;253;203;50
APIACÁS;50;179;1066;250;187;63
APIACÁS;50;180;1031;90;64;26
APIACÁS;50;182;1040;254;207;47
APIACÁS;50;183;1058;387;282;105
APIACÁS;50;184;1058;386;282;104
APIACÁS;50;185;1058;377;290;87
APIACÁS;50;186;1058;379;271;108
NOVA BANDEIRANTES;50;187;1040;302;205;97
NOVA BANDEIRANTES;50;188;1040;307;217;90
NOVA BANDEIRANTES;50;189;1082;100;72;28
NOVA BANDEIRANTES;50;190;1040;303;204;99
NOVA MONTE VERDE;50;191;1058;327;219;108
NOVA BANDEIRANTES;50;192;1015;366;249;117
NOVA MONTE VERDE;50;193;1023;326;230;96
NOVA MONTE VERDE;50;194;1023;295;215;80
APIACÁS;50;195;1058;167;137;30
CUIABÁ;51;1;1015;228;203;25
CUIABÁ;51;2;1023;399;333;66
CUIABÁ;51;3;1023;398;336;62
CUIABÁ;51;4;1023;394;314;80
CUIABÁ;51;5;1023;392;333;59
CUIABÁ;51;6;1023;395;331;64
CUIABÁ;51;7;1023;390;316;74
CUIABÁ;51;8;1023;395;324;71
CUIABÁ;51;9;1023;395;327;68
CUIABÁ;51;10;1023;393;327;66
CUIABÁ;51;24;1040;233;200;33
CUIABÁ;51;25;1040;227;200;27
CUIABÁ;51;26;1040;227;196;31
CUIABÁ;51;27;1040;233;194;39
CUIABÁ;51;28;1040;228;198;30
CUIABÁ;51;29;1040;230;208;22
CUIABÁ;51;36;1066;323;280;43
CUIABÁ;51;37;1066;321;280;41
CUIABÁ;51;38;1066;323;279;44
CUIABÁ;51;39;1066;320;288;32
CUIABÁ;51;40;1066;327;283;44
CUIABÁ;51;41;1066;322;272;50
CUIABÁ;51;42;1066;323;273;50
CUIABÁ;51;43;1066;321;283;38
CUIABÁ;51;44;1066;322;263;59
CUIABÁ;51;45;1066;319;276;43
CUIABÁ;51;46;1066;322;287;35
CUIABÁ;51;48;1082;270;231;39
CUIABÁ;51;49;1090;385;313;72
CUIABÁ;51;49;1090;384;312;72
CUIABÁ;51;50;1090;382;312;70
CUIABÁ;51;51;1066;324;285;39
CUIABÁ;51;54;1066;317;279;38
CUIABÁ;51;55;1090;383;312;71
CUIABÁ;51;56;1090;378;311;67
CUIABÁ;51;57;1104;373;312;61
CUIABÁ;51;58;1120;393;333;60
CUIABÁ;51;60;1023;386;324;62
CUIABÁ;51;61;1066;322;273;49
CUIABÁ;51;62;1104;366;312;54
CUIABÁ;51;63;1112;387;326;61
CUIABÁ;51;64;1112;381;310;71
CUIABÁ;51;65;1147;388;328;60
CUIABÁ;51;67;1090;379;330;49
CUIABÁ;51;68;1104;366;304;62
CUIABÁ;51;70;1155;375;320;55
CUIABÁ;51;71;1155;371;318;53
CUIABÁ;51;72;1155;369;312;57
CUIABÁ;51;73;1155;372;322;50
CUIABÁ;51;74;1112;379;320;59
CUIABÁ;51;75;1147;388;313;75
CUIABÁ;51;76;1163;386;318;68
CUIABÁ;51;77;1120;392;327;65
CUIABÁ;51;78;1040;226;206;20
CUIABÁ;51;79;1023;389;310;79
CUIABÁ;51;80;1066;322;292;30
CUIABÁ;51;81;1104;371;310;61
CUIABÁ;51;82;1112;380;317;63
CUIABÁ;51;83;1147;388;336;52
CUIABÁ;51;84;1040;225;192;33
CUIABÁ;51;85;1120;397;315;82
CUIABÁ;51;86;1171;340;287;53
CUIABÁ;51;87;1171;342;299;43
CUIABÁ;51;88;1040;228;191;37
CUIABÁ;51;89;1163;396;328;68
CUIABÁ;51;90;1180;379;334;45
CUIABÁ;51;91;1171;336;288;48
CUIABÁ;51;92;1104;367;302;65
CUIABÁ;51;93;1040;227;204;23
CUIABÁ;51;94;1147;384;321;63
CUIABÁ;51;95;1112;380;313;67
CUIABÁ;51;96;1104;371;309;62
CUIABÁ;51;97;1171;340;291;49
CUIABÁ;51;98;1120;391;323;68
CUIABÁ;51;99;1155;372;321;51
CUIABÁ;51;100;1112;377;306;71
CUIABÁ;51;101;1180;379;321;58
CUIABÁ;51;102;1104;366;302;64
CUIABÁ;51;103;1163;394;320;74
CUIABÁ;51;104;1147;378;306;72
CUIABÁ;51;105;1040;230;212;18
CUIABÁ;51;106;1171;338;291;47
CUIABÁ;51;107;1090;380;312;68
CUIABÁ;51;108;1112;366;306;60
CUIABÁ;51;109;1104;367;293;74
CUIABÁ;51;110;1180;376;317;59
CUIABÁ;51;111;1171;337;297;40
CUIABÁ;51;112;1040;224;188;36
CUIABÁ;51;113;1120;391;330;61
CUIABÁ;51;114;1155;370;306;64
CUIABÁ;51;115;1171;338;290;48
CUIABÁ;51;116;1180;379;328;51
CUIABÁ;51;117;1023;387;321;66
CUIABÁ;51;118;1112;376;309;67
CUIABÁ;51;119;1163;387;327;60
CUIABÁ;51;120;1040;222;183;39
CUIABÁ;51;121;1147;384;329;55
CUIABÁ;51;122;1104;369;310;59
CUIABÁ;51;123;1171;336;284;52
CUIABÁ;51;124;1112;373;308;65
CUIABÁ;51;125;1180;375;329;46
CUIABÁ;51;126;1090;372;302;70
CUIABÁ;51;127;1120;388;319;69
CUIABÁ;51;128;1015;230;201;29
CUIABÁ;51;129;1023;389;314;75
CUIABÁ;51;130;1147;386;327;59
CUIABÁ;51;132;1155;371;316;55
CUIABÁ;51;133;1210;386;315;71
CUIABÁ;51;134;1520;283;234;49
CUIABÁ;51;135;1104;366;298;68
CUIABÁ;51;136;1040;231;189;42
CUIABÁ;51;137;1112;371;311;60
CUIABÁ;51;138;1180;373;320;53
CUIABÁ;51;139;1163;386;313;73
CUIABÁ;51;140;1520;280;253;27
CUIABÁ;51;141;1023;390;325;65
CUIABÁ;51;142;1090;382;309;73
CUIABÁ;51;143;1147;384;327;57
CUIABÁ;51;145;1171;334;286;48
CUIABÁ;51;146;1180;370;309;61
CUIABÁ;51;147;1112;382;327;55
CUIABÁ;51;148;1155;370;308;62
CUIABÁ;51;149;1210;383;308;75
CUIABÁ;51;150;1120;390;317;73
CUIABÁ;51;151;1228;393;318;75
CUIABÁ;51;152;1236;386;309;77
CUIABÁ;51;153;1163;386;321;65
CUIABÁ;51;154;1104;369;317;52
CUIABÁ;51;155;1244;401;338;63
CUIABÁ;51;156;1244;397;339;58
CUIABÁ;51;157;1244;395;330;65
CUIABÁ;51;158;1244;396;340;56
CUIABÁ;51;159;1244;394;324;70
CUIABÁ;51;161;1244;397;339;58
CUIABÁ;51;162;1244;391;325;66
CUIABÁ;51;163;1252;257;220;37
CUIABÁ;51;164;1252;257;220;37
CUIABÁ;51;165;1252;258;219;39
CUIABÁ;51;166;1252;253;228;25
CUIABÁ;51;167;1252;256;222;34
CUIABÁ;51;168;1252;258;223;35
CUIABÁ;51;169;1252;259;224;35
CUIABÁ;51;170;1252;252;223;29
CUIABÁ;51;171;1252;252;216;36
CUIABÁ;51;172;1260;357;308;49
CUIABÁ;51;172;1260;356;307;49
CUIABÁ;51;173;1260;353;302;51
CUIABÁ;51;174;1260;349;294;55
CUIABÁ;51;175;1260;351;288;63
CUIABÁ;51;176;1260;352;297;55
CUIABÁ;51;177;1260;350;307;43
CUIABÁ;51;178;1260;355;316;39
CUIABÁ;51;179;1260;349;303;46
CUIABÁ;51;180;1260;345;282;63
CUIABÁ;51;181;1260;354;293;61
CUIABÁ;51;182;1260;349;300;49
CUIABÁ;51;183;1279;266;221;45
CUIABÁ;51;184;1279;265;224;41
CUIABÁ;51;185;1279;267;233;34
CUIABÁ;51;186;1279;266;240;26
CUIABÁ;51;188;1279;267;233;34
CUIABÁ;51;189;1287;389;319;70
CUIABÁ;51;190;1287;381;304;77
CUIABÁ;51;191;1287;381;316;65
CUIABÁ;51;192;1287;382;312;70
CUIABÁ;51;193;1287;384;321;63
CUIABÁ;51;194;1287;385;308;77
CUIABÁ;51;195;1287;382;322;60
CUIABÁ;51;196;1287;380;305;75
CUIABÁ;51;197;1287;383;313;70
CUIABÁ;51;198;1287;384;325;59
CUIABÁ;51;199;1287;379;304;75
CUIABÁ;51;200;1287;378;323;55
CUIABÁ;51;201;1287;384;303;81
CUIABÁ;51;202;1287;384;326;58
CUIABÁ;51;203;1287;381;329;52
CUIABÁ;51;204;1295;316;264;52
CUIABÁ;51;205;1295;308;259;49
CUIABÁ;51;206;1295;307;259;48
CUIABÁ;51;207;1295;311;255;56
CUIABÁ;51;208;1295;309;268;41
CUIABÁ;51;209;1295;309;251;58
CUIABÁ;51;210;1295;308;260;48
CUIABÁ;51;211;1295;312;276;36
CUIABÁ;51;212;1295;311;273;38
CUIABÁ;51;213;1295;306;271;35
CUIABÁ;51;214;1295;310;264;46
CUIABÁ;51;215;1295;308;256;52
CUIABÁ;51;216;1309;343;291;52
CUIABÁ;51;217;1309;340;279;61
CUIABÁ;51;219;1309;339;273;66
CUIABÁ;51;220;1309;342;289;53
CUIABÁ;51;221;1317;272;236;36
CUIABÁ;51;222;1317;268;231;37
CUIABÁ;51;223;1317;257;218;39
CUIABÁ;51;224;1422;327;284;43
CUIABÁ;51;225;1422;330;287;43
CUIABÁ;51;226;1422;324;269;55
CUIABÁ;51;227;1422;331;289;42
CUIABÁ;51;228;1422;330;286;44
CUIABÁ;51;229;1422;330;279;51
CUIABÁ;51;230;1422;324;270;54
CUIABÁ;51;231;1333;396;324;72
CUIABÁ;51;232;1333;392;336;56
CUIABÁ;51;233;1333;390;338;52
CUIABÁ;51;234;1333;390;336;54
CUIABÁ;51;235;1333;387;327;60
CUIABÁ;51;236;1341;340;296;44
CUIABÁ;51;237;1341;346;295;51
CUIABÁ;51;238;1350;318;279;39
CUIABÁ;51;238;1350;317;278;39
CUIABÁ;51;239;1350;311;265;46
CUIABÁ;51;240;1368;361;309;52
CUIABÁ;51;241;1368;358;303;55
CUIABÁ;51;242;1112;379;327;52
CUIABÁ;51;243;1023;395;326;69
CUIABÁ;51;244;1252;253;211;42
CUIABÁ;51;245;1309;341;273;68
CUIABÁ;51;246;1147;380;322;58
CUIABÁ;51;247;1180;381;326;55
CUIABÁ;51;248;1368;352;306;46
CUIABÁ;51;249;1090;382;301;81
CUIABÁ;51;250;1155;367;320;47
CUIABÁ;51;251;1171;341;288;53
CUIABÁ;51;252;1260;344;290;54
CUIABÁ;51;253;1350;307;267;40
CUIABÁ;51;255;1112;371;305;66
CUIABÁ;51;256;1163;385;319;66
CUIABÁ;51;257;1180;373;318;55
CUIABÁ;51;258;1341;336;283;53
CUIABÁ;51;259;1147;388;323;65
CUIABÁ;51;260;1112;377;305;72
CUIABÁ;51;261;1155;368;314;54
CUIABÁ;51;262;1120;389;331;58
CUIABÁ;51;264;1210;384;306;78
CUIABÁ;51;265;1520;279;238;41
CUIABÁ;51;266;1090;379;313;66
CUIABÁ;51;267;1104;369;304;65
CUIABÁ;51;268;1180;377;316;61
CUIABÁ;51;269;1341;334;276;58
CUIABÁ;51;270;1236;386;311;75
CUIABÁ;51;271;1279;263;235;28
CUIABÁ;51;272;1422;331;280;51
CUIABÁ;51;273;1244;387;317;70
CUIABÁ;51;274;1066;323;272;51
CUIABÁ;51;275;1163;387;320;67
CUIABÁ;51;276;1171;335;292;43
CUIABÁ;51;277;1376;391;337;54
CUIABÁ;51;278;1023;386;318;68
CUIABÁ;51;279;1112;379;301;78
CUIABÁ;51;280;1422;302;250;52
CUIABÁ;51;281;1422;329;276;53
CUIABÁ;51;283;1333;381;326;55
CUIABÁ;51;284;1180;377;318;59
CUIABÁ;51;285;1147;380;309;71
CUIABÁ;51;286;1414;350;290;60
CUIABÁ;51;288;1120;393;328;65
CUIABÁ;51;289;1414;348;290;58
CUIABÁ;51;290;1023;389;316;73
CUIABÁ;51;292;1155;373;324;49
CUIABÁ;51;293;1287;370;304;66
CUIABÁ;51;294;1376;386;306;80
CUIABÁ;51;295;1163;387;324;63
CUIABÁ;51;296;1210;373;276;97
CUIABÁ;51;297;1104;372;316;56
CUIABÁ;51;298;1180;374;315;59
CUIABÁ;51;300;1147;388;321;67
CUIABÁ;51;301;1171;336;275;61
CUIABÁ;51;302;1112;380;310;70
CUIABÁ;51;303;1228;393;325;68
CUIABÁ;51;304;1422;326;266;60
CUIABÁ;51;305;1376;385;332;53
CUIABÁ;51;306;1120;395;321;74
CUIABÁ;51;307;1430;301;254;47
CUIABÁ;51;308;1422;333;266;67
CUIABÁ;51;309;1520;324;284;40
CUIABÁ;51;310;1449;138;109;29
CUIABÁ;51;311;1180;377;299;78
CUIABÁ;51;312;1236;395;329;66
CUIABÁ;51;313;1163;381;311;70
CUIABÁ;51;315;1090;380;308;72
CUIABÁ;51;316;1104;370;291;79
CUIABÁ;51;317;1376;381;304;77
CUIABÁ;51;318;1317;274;235;39
CUIABÁ;51;319;1457;400;337;63
CUIABÁ;51;320;1457;391;338;53
CUIABÁ;51;321;1457;390;328;62
CUIABÁ;51;322;1457;388;326;62
CUIABÁ;51;323;1457;383;332;51
CUIABÁ;51;324;1457;392;342;50
CUIABÁ;51;325;1457;387;337;50
CUIABÁ;51;326;1457;392;332;60
CUIABÁ;51;327;1457;388;336;52
CUIABÁ;51;328;1457;394;341;53
CUIABÁ;51;329;1465;385;338;47
CUIABÁ;51;330;1465;375;326;49
CUIABÁ;51;330;1465;374;325;49
CUIABÁ;51;331;1465;381;315;66
CUIABÁ;51;332;1465;377;320;57
CUIABÁ;51;333;1465;377;318;59
CUIABÁ;51;334;1465;378;326;52
CUIABÁ;51;335;1414;359;303;56
CUIABÁ;51;336;1430;317;276;41
CUIABÁ;51;337;1376;387;339;48
CUIABÁ;51;338;1180;378;324;54
CUIABÁ;51;339;1210;382;294;88
CUIABÁ;51;340;1120;394;332;62
CUIABÁ;51;341;1473;393;328;65
CUIABÁ;51;342;1112;383;306;77
CUIABÁ;51;343;1287;387;321;66
CUIABÁ;51;344;1376;382;315;67
CUIABÁ;51;345;1104;371;282;89
CUIABÁ;51;346;1465;381;313;68
CUIABÁ;51;347;1473;389;331;58
CUIABÁ;51;348;1236;390;313;77
CUIABÁ;51;349;1376;387;313;74
CUIABÁ;51;350;1180;378;298;80
CUIABÁ;51;351;1333;390;318;72
CUIABÁ;51;352;1430;287;238;49
CUIABÁ;51;353;1120;393;302;91
CUIABÁ;51;354;1350;312;257;55
CUIABÁ;51;355;1104;370;283;87
CUIABÁ;51;356;1414;353;273;80
CUIABÁ;51;357;1082;151;130;21
CUIABÁ;51;358;1430;277;216;61
CUIABÁ;51;359;1473;394;300;94
CUIABÁ;51;360;1376;377;283;94
CUIABÁ;51;361;1210;194;159;35
CUIABÁ;51;362;1376;251;216;35
CUIABÁ;51;363;1473;108;94;14
CUIABÁ;51;364;1236;80;68;12
CUIABÁ;51;365;1503;78;47;31
CUIABÁ;51;366;1333;115;96;19
CUIABÁ;51;367;1163;89;70;19
RIO BRANCO;52;2;1015;378;271;107
RIO BRANCO;52;3;1015;381;306;75
RIO BRANCO;52;4;1015;381;286;95
RIO BRANCO;52;6;1015;382;285;97
RIO BRANCO;52;7;1015;378;285;93
RIO BRANCO;52;11;1015;382;310;72
RIO BRANCO;52;12;1074;223;173;50
RIO BRANCO;52;14;1015;381;300;81
RIO BRANCO;52;15;1074;220;158;62
RIO BRANCO;52;16;1074;220;163;57
RIO BRANCO;52;17;1074;220;157;63
SALTO DO CÉU;52;19;1015;368;287;81
SALTO DO CÉU;52;20;1015;371;286;85
SALTO DO CÉU;52;21;1015;367;276;91
SALTO DO CÉU;52;22;1015;370;288;82
SALTO DO CÉU;52;26;1015;369;294;75
SALTO DO CÉU;52;27;1058;192;152;40
SALTO DO CÉU;52;28;1031;294;213;81
SALTO DO CÉU;52;32;1040;214;178;36
LAMBARI D'OESTE;52;34;1015;285;217;68
LAMBARI D'OESTE;52;35;1015;299;212;87
LAMBARI D'OESTE;52;36;1015;295;210;85
LAMBARI D'OESTE;52;37;1015;292;210;82
LAMBARI D'OESTE;52;38;1015;294;193;101
LAMBARI D'OESTE;52;39;1015;280;216;64
LAMBARI D'OESTE;52;41;1058;225;170;55
LAMBARI D'OESTE;52;42;1058;217;167;50
LAMBARI D'OESTE;52;48;1074;370;236;134
LAMBARI D'OESTE;52;111;1082;237;171;66
SALTO DO CÉU;52;119;1058;380;307;73
LAMBARI D'OESTE;52;120;1058;336;238;98
RIO BRANCO;52;121;1074;214;165;49
RIO BRANCO;52;141;1074;217;171;46
LAMBARI D'OESTE;52;150;1015;278;205;73
LAMBARI D'OESTE;52;151;1015;282;190;92
SÃO JOSÉ DOS QUATRO MARCOS;52;153;1015;235;167;68
SÃO JOSÉ DOS QUATRO MARCOS;52;153;1015;234;166;68
SÃO JOSÉ DOS QUATRO MARCOS;52;154;1015;236;171;65
SÃO JOSÉ DOS QUATRO MARCOS;52;155;1015;237;168;69
SÃO JOSÉ DOS QUATRO MARCOS;52;156;1015;232;180;52
SÃO JOSÉ DOS QUATRO MARCOS;52;157;1015;233;169;64
SÃO JOSÉ DOS QUATRO MARCOS;52;158;1015;246;183;63
SÃO JOSÉ DOS QUATRO MARCOS;52;159;1015;241;183;58
SÃO JOSÉ DOS QUATRO MARCOS;52;160;1015;243;170;73
SÃO JOSÉ DOS QUATRO MARCOS;52;161;1015;234;174;60
SÃO JOSÉ DOS QUATRO MARCOS;52;162;1015;234;167;67
SÃO JOSÉ DOS QUATRO MARCOS;52;163;1015;237;179;58
SÃO JOSÉ DOS QUATRO MARCOS;52;164;1015;236;184;52
SÃO JOSÉ DOS QUATRO MARCOS;52;165;1023;233;165;68
SÃO JOSÉ DOS QUATRO MARCOS;52;166;1023;233;166;67
SÃO JOSÉ DOS QUATRO MARCOS;52;167;1023;227;155;72
SÃO JOSÉ DOS QUATRO MARCOS;52;168;1023;236;154;82
SÃO JOSÉ DOS QUATRO MARCOS;52;169;1023;232;174;58
SÃO JOSÉ DOS QUATRO MARCOS;52;170;1023;227;155;72
SÃO JOSÉ DOS QUATRO MARCOS;52;171;1023;220;153;67
SÃO JOSÉ DOS QUATRO MARCOS;52;172;1023;225;164;61
SÃO JOSÉ DOS QUATRO MARCOS;52;173;1023;227;178;49
SÃO JOSÉ DOS QUATRO MARCOS;52;174;1023;232;176;56
SÃO JOSÉ DOS QUATRO MARCOS;52;175;1031;233;164;69
SÃO JOSÉ DOS QUATRO MARCOS;52;176;1031;230;168;62
SÃO JOSÉ DOS QUATRO MARCOS;52;177;1031;226;176;50
SÃO JOSÉ DOS QUATRO MARCOS;52;178;1031;223;170;53
SÃO JOSÉ DOS QUATRO MARCOS;52;179;1031;233;162;71
SÃO JOSÉ DOS QUATRO MARCOS;52;180;1031;225;174;51
SÃO JOSÉ DOS QUATRO MARCOS;52;181;1031;219;169;50
SÃO JOSÉ DOS QUATRO MARCOS;52;182;1040;311;201;110
SÃO JOSÉ DOS QUATRO MARCOS;52;183;1040;307;205;102
SÃO JOSÉ DOS QUATRO MARCOS;52;184;1040;302;201;101
SÃO JOSÉ DOS QUATRO MARCOS;52;185;1040;313;213;100
SÃO JOSÉ DOS QUATRO MARCOS;52;186;1040;300;228;72
SÃO JOSÉ DOS QUATRO MARCOS;52;187;1058;245;164;81
SÃO JOSÉ DOS QUATRO MARCOS;52;188;1058;251;165;86
SÃO JOSÉ DOS QUATRO MARCOS;52;189;1058;249;165;84
SÃO JOSÉ DOS QUATRO MARCOS;52;190;1058;244;157;87
SÃO JOSÉ DOS QUATRO MARCOS;52;192;1066;353;227;126
SÃO JOSÉ DOS QUATRO MARCOS;52;194;1074;250;182;68
SÃO JOSÉ DOS QUATRO MARCOS;52;197;1082;310;223;87
SÃO JOSÉ DOS QUATRO MARCOS;52;200;1082;304;217;87
SÃO JOSÉ DOS QUATRO MARCOS;52;204;1090;231;150;81
SÃO JOSÉ DOS QUATRO MARCOS;52;207;1104;326;245;81
SÃO JOSÉ DOS QUATRO MARCOS;52;208;1104;330;248;82
SÃO JOSÉ DOS QUATRO MARCOS;52;209;1112;228;156;72
SÃO JOSÉ DOS QUATRO MARCOS;52;210;1112;228;177;51
SÃO JOSÉ DOS QUATRO MARCOS;52;211;1112;218;164;54
SÃO JOSÉ DOS QUATRO MARCOS;52;212;1112;227;162;65
SÃO JOSÉ DOS QUATRO MARCOS;52;213;1112;226;155;71
SÃO JOSÉ DOS QUATRO MARCOS;52;214;1112;222;171;51
LAMBARI D'OESTE;52;215;1015;289;194;95
SÃO JOSÉ DOS QUATRO MARCOS;52;216;1104;309;236;73
SÃO JOSÉ DOS QUATRO MARCOS;52;217;1031;219;170;49
SÃO JOSÉ DOS QUATRO MARCOS;52;217;1031;218;169;49
SÃO JOSÉ DOS QUATRO MARCOS;52;218;1040;286;192;94
SÃO JOSÉ DOS QUATRO MARCOS;52;219;1058;243;184;59
SÃO JOSÉ DOS QUATRO MARCOS;52;220;1104;295;233;62
SÃO JOSÉ DOS QUATRO MARCOS;52;221;1112;206;157;49
LAMBARI D'OESTE;52;224;1015;409;321;88
BOM JESUS DO ARAGUAIA;53;89;1040;277;184;93
BOM JESUS DO ARAGUAIA;53;90;1040;275;186;89
BOM JESUS DO ARAGUAIA;53;91;1040;286;199;87
BOM JESUS DO ARAGUAIA;53;92;1040;276;193;83
BOM JESUS DO ARAGUAIA;53;93;1040;262;187;75
BOM JESUS DO ARAGUAIA;53;94;1040;259;182;77
BOM JESUS DO ARAGUAIA;53;94;1040;258;181;77
BOM JESUS DO ARAGUAIA;53;95;1040;256;171;85
BOM JESUS DO ARAGUAIA;53;96;1040;253;180;73
BOM JESUS DO ARAGUAIA;53;97;1031;252;197;55
BOM JESUS DO ARAGUAIA;53;98;1031;252;181;71
SERRA NOVA DOURADA;53;99;1015;353;246;107
SERRA NOVA DOURADA;53;100;1015;356;249;107
SERRA NOVA DOURADA;53;101;1015;351;262;89
BOM JESUS DO ARAGUAIA;53;103;1040;258;182;76
SERRA NOVA DOURADA;53;104;1015;352;233;119
BOM JESUS DO ARAGUAIA;53;105;1040;256;173;83
BOM JESUS DO ARAGUAIA;53;108;1058;394;261;133
BOM JESUS DO ARAGUAIA;53;109;1058;396;280;116
BOM JESUS DO ARAGUAIA;53;111;1058;437;293;144
BOM JESUS DO ARAGUAIA;53;112;1066;227;173;54
QUERÊNCIA;53;113;1015;376;305;71
QUERÊNCIA;53;114;1015;375;292;83
QUERÊNCIA;53;115;1015;381;294;87
QUERÊNCIA;53;116;1015;378;297;81
QUERÊNCIA;53;117;1015;371;281;90
QUERÊNCIA;53;118;1015;373;273;100
QUERÊNCIA;53;119;1015;375;282;93
QUERÊNCIA;53;120;1015;377;273;104
QUERÊNCIA;53;121;1015;369;248;121
QUERÊNCIA;53;122;1015;375;281;94
QUERÊNCIA;53;123;1031;350;198;152
QUERÊNCIA;53;124;1040;397;282;115
QUERÊNCIA;53;125;1040;392;270;122
QUERÊNCIA;53;126;1040;392;276;116
QUERÊNCIA;53;127;1040;388;282;106
QUERÊNCIA;53;128;1040;388;286;102
QUERÊNCIA;53;129;1040;391;274;117
QUERÊNCIA;53;130;1040;392;257;135
QUERÊNCIA;53;131;1058;377;274;103
QUERÊNCIA;53;132;1058;377;274;103
QUERÊNCIA;53;133;1058;381;265;116
QUERÊNCIA;53;134;1058;382;285;97
QUERÊNCIA;53;135;1058;383;276;107
QUERÊNCIA;53;136;1058;374;271;103
QUERÊNCIA;53;137;1058;379;251;128
QUERÊNCIA;53;138;1066;317;198;119
QUERÊNCIA;53;139;1074;353;228;125
QUERÊNCIA;53;140;1074;356;222;134
QUERÊNCIA;53;141;1074;360;227;133
QUERÊNCIA;53;142;1082;390;278;112
QUERÊNCIA;53;143;1082;390;258;132
QUERÊNCIA;53;143;1082;389;257;132
QUERÊNCIA;53;144;1082;395;254;141
QUERÊNCIA;53;145;1112;247;169;78
QUERÊNCIA;53;146;1112;244;155;89
BOM JESUS DO ARAGUAIA;53;147;1058;396;259;137
QUERÊNCIA;53;148;1082;397;292;105
QUERÊNCIA;53;149;1040;396;307;89
QUERÊNCIA;53;150;1074;362;267;95
QUERÊNCIA;53;151;1066;120;99;21
QUERÊNCIA;53;151;1066;119;98;21
QUERÊNCIA;53;152;1058;390;297;93
QUERÊNCIA;53;153;1015;377;296;81
SERRA NOVA DOURADA;53;154;1015;212;166;46
QUERÊNCIA;53;155;1031;53;39;14
QUERÊNCIA;53;155;1031;52;38;14
QUERÊNCIA;53;156;1058;373;311;62
CUIABÁ;55;1;1015;394;342;52
CUIABÁ;55;2;1015;388;331;57
CUIABÁ;55;3;1015;388;330;58
CUIABÁ;55;4;1015;385;320;65
CUIABÁ;55;5;1023;268;220;48
CUIABÁ;55;6;1023;263;222;41
CUIABÁ;55;7;1023;329;273;56
CUIABÁ;55;7;1023;280;233;47
CUIABÁ;55;8;1023;264;229;35
CUIABÁ;55;9;1023;263;222;41
CUIABÁ;55;10;1023;262;222;40
CUIABÁ;55;11;1023;261;233;28
CUIABÁ;55;12;1031;334;293;41
CUIABÁ;55;13;1031;330;291;39
CUIABÁ;55;14;1031;330;283;47
CUIABÁ;55;15;1031;328;283;45
CUIABÁ;55;16;1040;386;314;72
CUIABÁ;55;17;1040;384;321;63
CUIABÁ;55;18;1040;380;307;73
CUIABÁ;55;19;1040;385;307;78
CUIABÁ;55;20;1040;385;327;58
CUIABÁ;55;21;1040;382;303;79
CUIABÁ;55;22;1040;387;315;72
CUIABÁ;55;23;1040;381;306;75
CUIABÁ;55;24;1171;287;257;30
CUIABÁ;55;25;1171;285;246;39
CUIABÁ;55;26;1058;364;300;64
CUIABÁ;55;27;1058;366;297;69
CUIABÁ;55;28;1058;361;298;63
CUIABÁ;55;29;1058;362;311;51
CUIABÁ;55;30;1058;363;290;73
CUIABÁ;55;31;1058;362;291;71
CUIABÁ;55;32;1066;359;292;67
CUIABÁ;55;33;1066;360;285;75
CUIABÁ;55;34;1066;355;286;69
CUIABÁ;55;35;1066;360;281;79
CUIABÁ;55;36;1066;358;293;65
CUIABÁ;55;37;1066;353;279;74
CUIABÁ;55;38;1180;399;337;62
CUIABÁ;55;40;1180;398;343;55
CUIABÁ;55;41;1074;377;316;61
CUIABÁ;55;42;1074;374;309;65
CUIABÁ;55;43;1074;376;321;55
CUIABÁ;55;44;1074;379;316;63
CUIABÁ;55;45;1082;178;149;29
CUIABÁ;55;46;1090;393;299;94
CUIABÁ;55;47;1090;389;305;84
CUIABÁ;55;48;1090;392;309;83
CUIABÁ;55;49;1058;364;304;60
CUIABÁ;55;50;1074;374;305;69
CUIABÁ;55;51;1171;289;257;32
CUIABÁ;55;52;1104;387;330;57
CUIABÁ;55;53;1503;372;298;74
CUIABÁ;55;54;1120;387;318;69
CUIABÁ;55;55;1120;385;316;69
CUIABÁ;55;56;1139;380;313;67
CUIABÁ;55;57;1147;347;315;32
CUIABÁ;55;58;1503;362;293;69
CUIABÁ;55;59;1031;333;291;42
CUIABÁ;55;60;1090;391;311;80
CUIABÁ;55;61;1090;391;310;81
CUIABÁ;55;62;1104;384;323;61
CUIABÁ;55;63;1147;343;293;50
CUIABÁ;55;64;1120;378;296;82
CUIABÁ;55;65;1163;382;329;53
CUIABÁ;55;66;1198;369;317;52
CUIABÁ;55;67;1198;364;310;54
CUIABÁ;55;69;1171;283;258;25
CUIABÁ;55;70;1120;384;284;100
CUIABÁ;55;71;1503;364;289;75
CUIABÁ;55;72;1090;389;312;77
CUIABÁ;55;73;1210;377;328;49
CUIABÁ;55;74;1201;380;308;72
CUIABÁ;55;76;1139;376;300;76
CUIABÁ;55;77;1147;346;291;55
CUIABÁ;55;78;1104;380;314;66
CUIABÁ;55;79;1058;364;298;66
CUIABÁ;55;80;1023;264;220;44
CUIABÁ;55;81;1198;370;325;45
CUIABÁ;55;82;1171;282;260;22
CUIABÁ;55;83;1210;375;318;57
CUIABÁ;55;84;1201;372;304;68
CUIABÁ;55;85;1201;371;307;64
CUIABÁ;55;86;1503;368;301;67
CUIABÁ;55;87;1210;375;325;50
CUIABÁ;55;88;1066;355;288;67
CUIABÁ;55;89;1210;374;303;71
CUIABÁ;55;90;1163;382;325;57
CUIABÁ;55;91;1201;366;306;60
CUIABÁ;55;92;1147;346;289;57
CUIABÁ;55;93;1139;374;300;74
CUIABÁ;55;94;1120;389;323;66
CUIABÁ;55;95;1104;382;329;53
CUIABÁ;55;96;1244;377;314;63
CUIABÁ;55;97;1023;262;226;36
CUIABÁ;55;98;1210;376;308;68
CUIABÁ;55;99;1031;332;278;54
CUIABÁ;55;100;1058;367;307;60
CUIABÁ;55;101;1090;388;309;79
CUIABÁ;55;102;1201;371;299;72
CUIABÁ;55;103;1120;383;311;72
CUIABÁ;55;104;1210;376;309;67
CUIABÁ;55;105;1244;376;307;69
CUIABÁ;55;106;1104;383;324;59
CUIABÁ;55;107;1139;376;319;57
CUIABÁ;55;108;1198;367;308;59
CUIABÁ;55;109;1023;260;229;31
CUIABÁ;55;110;1040;382;310;72
CUIABÁ;55;111;1503;366;296;70
CUIABÁ;55;112;1090;387;315;72
CUIABÁ;55;113;1147;345;300;45
CUIABÁ;55;114;1120;382;306;76
CUIABÁ;55;115;1252;428;318;110
CUIABÁ;55;116;1171;288;252;36
CUIABÁ;55;117;1201;368;311;57
CUIABÁ;55;118;1503;364;304;60
CUIABÁ;55;119;1104;382;326;56
CUIABÁ;55;120;1040;379;318;61
CUIABÁ;55;121;1058;366;307;59
CUIABÁ;55;122;1090;390;312;78
CUIABÁ;55;123;1120;382;325;57
CUIABÁ;55;124;1023;261;231;30
CUIABÁ;55;125;1139;374;309;65
CUIABÁ;55;126;1031;332;276;56
CUIABÁ;55;127;1260;356;305;51
CUIABÁ;55;128;1260;354;318;36
CUIABÁ;55;129;1260;351;310;41
CUIABÁ;55;130;1260;349;307;42
CUIABÁ;55;131;1260;352;295;57
CUIABÁ;55;132;1260;346;305;41
CUIABÁ;55;133;1260;348;294;54
CUIABÁ;55;134;1457;248;214;34
CUIABÁ;55;135;1457;242;205;37
CUIABÁ;55;136;1457;244;205;39
CUIABÁ;55;137;1457;247;211;36
CUIABÁ;55;139;1457;246;212;34
CUIABÁ;55;140;1457;249;219;30
CUIABÁ;55;141;1457;243;205;38
CUIABÁ;55;142;1287;403;320;83
CUIABÁ;55;143;1287;395;329;66
CUIABÁ;55;144;1287;395;327;68
CUIABÁ;55;145;1287;398;308;90
CUIABÁ;55;146;1287;391;308;83
CUIABÁ;55;147;1287;399;313;86
CUIABÁ;55;148;1287;401;311;90
CUIABÁ;55;149;1287;395;316;79
CUIABÁ;55;150;1287;398;310;88
CUIABÁ;55;151;1287;389;307;82
CUIABÁ;55;152;1295;347;289;58
CUIABÁ;55;153;1295;341;288;53
CUIABÁ;55;154;1295;340;288;52
CUIABÁ;55;155;1295;341;284;57
CUIABÁ;55;156;1295;347;284;63
CUIABÁ;55;157;1295;342;281;61
CUIABÁ;55;158;1295;340;279;61
CUIABÁ;55;159;1295;342;277;65
CUIABÁ;55;160;1295;341;280;61
CUIABÁ;55;161;1309;380;331;49
CUIABÁ;55;162;1309;387;334;53
CUIABÁ;55;163;1309;385;319;66
CUIABÁ;55;164;1309;381;317;64
CUIABÁ;55;165;1309;382;318;64
CUIABÁ;55;166;1309;385;330;55
CUIABÁ;55;167;1309;376;321;55
CUIABÁ;55;168;1309;382;320;62
CUIABÁ;55;169;1309;378;322;56
CUIABÁ;55;170;1309;382;316;66
CUIABÁ;55;171;1309;379;323;56
CUIABÁ;55;172;1309;384;316;68
CUIABÁ;55;173;1317;404;351;53
CUIABÁ;55;174;1317;397;335;62
CUIABÁ;55;175;1317;399;324;75
CUIABÁ;55;176;1317;396;323;73
CUIABÁ;55;177;1317;397;318;79
CUIABÁ;55;178;1317;395;333;62
CUIABÁ;55;179;1317;399;327;72
CUIABÁ;55;180;1317;399;326;73
CUIABÁ;55;181;1325;393;327;66
CUIABÁ;55;182;1325;394;346;48
CUIABÁ;55;183;1325;394;334;60
CUIABÁ;55;184;1325;391;324;67
CUIABÁ;55;185;1325;439;376;63
CUIABÁ;55;186;1333;376;318;58
CUIABÁ;55;187;1333;375;323;52
CUIABÁ;55;188;1333;380;318;62
CUIABÁ;55;189;1333;367;285;82
CUIABÁ;55;190;1333;368;307;61
CUIABÁ;55;191;1341;398;332;66
CUIABÁ;55;192;1341;393;334;59
CUIABÁ;55;193;1368;304;266;38
CUIABÁ;55;194;1368;303;267;36
CUIABÁ;55;195;1376;394;330;64
CUIABÁ;55;196;1376;393;343;50
CUIABÁ;55;197;1376;392;333;59
CUIABÁ;55;198;1384;397;325;72
CUIABÁ;55;199;1210;377;318;59
CUIABÁ;55;200;1244;375;305;70
CUIABÁ;55;201;1082;355;291;64
CUIABÁ;55;202;1503;362;301;61
CUIABÁ;55;203;1260;350;301;49
CUIABÁ;55;204;1104;382;324;58
CUIABÁ;55;205;1252;390;329;61
CUIABÁ;55;206;1287;393;314;79
CUIABÁ;55;207;1341;395;320;75
CUIABÁ;55;208;1333;369;315;54
CUIABÁ;55;209;1198;364;302;62
CUIABÁ;55;210;1040;387;311;76
CUIABÁ;55;211;1317;396;338;58
CUIABÁ;55;212;1201;372;309;63
CUIABÁ;55;213;1147;344;294;50
CUIABÁ;55;214;1090;385;315;70
CUIABÁ;55;215;1376;390;343;47
CUIABÁ;55;216;1406;388;324;64
CUIABÁ;55;217;1414;376;330;46
CUIABÁ;55;218;1392;390;318;72
CUIABÁ;55;219;1252;394;314;80
CUIABÁ;55;220;1325;395;338;57
CUIABÁ;55;221;1503;365;301;64
CUIABÁ;55;222;1139;377;306;71
CUIABÁ;55;223;1104;382;324;58
CUIABÁ;55;224;1023;258;224;34
CUIABÁ;55;225;1090;388;311;77
CUIABÁ;55;226;1406;389;308;81
CUIABÁ;55;227;1252;396;297;99
CUIABÁ;55;228;1406;388;322;66
CUIABÁ;55;229;1040;386;313;73
CUIABÁ;55;230;1244;374;302;72
CUIABÁ;55;231;1252;390;314;76
CUIABÁ;55;232;1503;368;307;61
CUIABÁ;55;233;1384;397;329;68
CUIABÁ;55;234;1066;377;319;58
CUIABÁ;55;234;1066;360;303;57
CUIABÁ;55;235;1066;378;314;64
CUIABÁ;55;235;1066;362;301;61
CUIABÁ;55;236;1163;384;328;56
CUIABÁ;55;237;1198;369;313;56
CUIABÁ;55;238;1317;397;328;69
CUIABÁ;55;239;1090;392;319;73
CUIABÁ;55;240;1058;364;298;66
CUIABÁ;55;241;1015;382;319;63
CUIABÁ;55;242;1147;347;286;61
CUIABÁ;55;243;1406;391;325;66
CUIABÁ;55;244;1457;246;207;39
CUIABÁ;55;245;1147;344;290;54
CUIABÁ;55;246;1104;384;310;74
CUIABÁ;55;247;1473;436;364;72
CUIABÁ;55;248;1333;374;315;59
CUIABÁ;55;249;1260;352;301;51
CUIABÁ;55;250;1252;392;305;87
CUIABÁ;55;251;1309;377;324;53
CUIABÁ;55;252;1376;387;335;52
CUIABÁ;55;253;1201;374;298;76
CUIABÁ;55;254;1090;387;291;96
CUIABÁ;55;255;1139;372;300;72
CUIABÁ;55;256;1210;376;306;70
CUIABÁ;55;257;1503;370;294;76
CUIABÁ;55;258;1066;353;287;66
CUIABÁ;55;259;1120;383;287;96
CUIABÁ;55;260;1244;378;313;65
CUIABÁ;55;261;1481;420;338;82
CUIABÁ;55;262;1341;394;335;59
CUIABÁ;55;263;1040;385;303;82
CUIABÁ;55;264;1198;366;317;49
CUIABÁ;55;265;1104;388;322;66
CUIABÁ;55;266;1384;409;331;78
CUIABÁ;55;267;1392;390;337;53
CUIABÁ;55;268;1090;393;306;87
CUIABÁ;55;269;1317;396;325;71
CUIABÁ;55;270;1120;387;294;93
CUIABÁ;55;271;1163;389;323;66
CUIABÁ;55;272;1074;376;302;74
CUIABÁ;55;273;1058;364;305;59
CUIABÁ;55;274;1287;394;306;88
CUIABÁ;55;275;1252;396;302;94
CUIABÁ;55;276;1341;398;348;50
CUIABÁ;55;277;1090;394;318;76
CUIABÁ;55;278;1325;389;334;55
CUIABÁ;55;279;1473;388;319;69
CUIABÁ;55;280;1244;379;313;66
CUIABÁ;55;281;1104;388;318;70
CUIABÁ;55;282;1503;369;288;81
CUIABÁ;55;283;1414;379;294;85
CUIABÁ;55;284;1341;396;339;57
CUIABÁ;55;285;1368;303;258;45
CUIABÁ;55;286;1287;399;315;84
CUIABÁ;55;287;1120;387;299;88
CUIABÁ;55;288;1333;373;302;71
CUIABÁ;55;289;1074;382;303;79
CUIABÁ;55;290;1139;381;298;83
CUIABÁ;55;291;1090;392;299;93
CUIABÁ;55;292;1163;386;318;68
CUIABÁ;55;293;1198;371;295;76
CUIABÁ;55;294;1341;398;323;75
CUIABÁ;55;295;1376;388;313;75
CUIABÁ;55;296;1392;387;302;85
CUIABÁ;55;297;1384;396;308;88
CUIABÁ;55;298;1244;377;281;96
CUIABÁ;55;299;1104;391;285;106
CUIABÁ;55;300;1090;391;285;106
CUIABÁ;55;301;1147;344;265;79
CUIABÁ;55;302;1252;398;281;117
CUIABÁ;55;303;1414;328;289;39
CUIABÁ;55;305;1503;371;292;79
CUIABÁ;55;308;1120;336;261;75
CUIABÁ;55;309;1090;388;283;105
CUIABÁ;55;310;1406;222;180;42
CUIABÁ;55;310;1406;164;135;29
CUIABÁ;55;311;1015;170;145;25
CUIABÁ;55;311;1015;124;103;21
BRASNORTE;56;90;1015;361;245;116
BRASNORTE;56;91;1015;361;248;113
BRASNORTE;56;92;1015;360;260;100
BRASNORTE;56;93;1015;363;273;90
BRASNORTE;56;94;1015;357;269;88
BRASNORTE;56;95;1015;360;282;78
BRASNORTE;56;96;1015;352;249;103
BRASNORTE;56;97;1015;355;246;109
BRASNORTE;56;98;1015;363;283;80
BRASNORTE;56;99;1023;352;235;117
BRASNORTE;56;100;1023;358;254;104
BRASNORTE;56;101;1023;358;257;101
BRASNORTE;56;102;1023;359;250;109
BRASNORTE;56;103;1023;357;262;95
BRASNORTE;56;104;1023;358;256;102
BRASNORTE;56;105;1023;360;237;123
BRASNORTE;56;106;1031;305;228;77
BRASNORTE;56;108;1040;249;169;80
BRASNORTE;56;109;1058;224;148;76
BRASNORTE;56;110;1066;323;243;80
BRASNORTE;56;111;1120;278;205;73
BRASNORTE;56;112;1104;202;136;66
BRASNORTE;56;113;1104;207;142;65
BRASNORTE;56;114;1104;205;138;67
BRASNORTE;56;115;1112;280;189;91
BRASNORTE;56;116;1015;356;239;117
BRASNORTE;56;118;1112;284;207;77
BRASNORTE;56;119;1147;330;203;127
BRASNORTE;56;120;1058;222;147;75
BRASNORTE;56;121;1147;322;199;123
BRASNORTE;56;122;1147;324;226;98
BRASNORTE;56;123;1147;332;224;108
BRASNORTE;56;125;1066;320;275;45
BRASNORTE;56;125;1066;319;275;44
BRASNORTE;56;127;1104;205;142;63
BRASNORTE;56;128;1147;336;204;132
BRASNORTE;56;129;1155;85;82;3
BRASNORTE;56;130;1147;339;247;92
BRASNORTE;56;131;1015;360;255;105
PARANATINGA;57;1;1015;280;194;86
PARANATINGA;57;2;1015;282;198;84
PARANATINGA;57;3;1015;284;212;72
PARANATINGA;57;4;1015;284;206;78
PARANATINGA;57;5;1015;279;189;90
PARANATINGA;57;6;1023;345;257;88
PARANATINGA;57;7;1023;340;263;77
PARANATINGA;57;8;1023;344;248;96
PARANATINGA;57;9;1023;341;249;92
PARANATINGA;57;10;1023;347;244;103
PARANATINGA;57;11;1023;343;249;94
PARANATINGA;57;12;1023;344;243;101
PARANATINGA;57;13;1023;348;258;90
PARANATINGA;57;14;1031;329;238;91
PARANATINGA;57;14;1031;328;237;91
PARANATINGA;57;15;1031;332;211;121
PARANATINGA;57;16;1031;331;224;107
PARANATINGA;57;17;1031;332;239;93
PARANATINGA;57;18;1031;329;244;85
PARANATINGA;57;19;1040;355;252;103
PARANATINGA;57;20;1040;357;270;87
PARANATINGA;57;21;1040;351;251;100
PARANATINGA;57;22;1040;351;253;98
PARANATINGA;57;23;1040;350;254;96
PARANATINGA;57;24;1058;298;248;50
PARANATINGA;57;25;1015;281;213;68
PARANATINGA;57;26;1090;226;153;73
PARANATINGA;57;27;1082;382;294;88
PARANATINGA;57;29;1090;230;171;59
PARANATINGA;57;30;1015;282;198;84
PARANATINGA;57;31;1112;409;282;127
PARANATINGA;57;32;1090;226;161;65
PARANATINGA;57;33;1139;386;274;112
GAÚCHA DO NORTE;57;34;1015;333;256;77
GAÚCHA DO NORTE;57;34;1015;332;255;77
GAÚCHA DO NORTE;57;35;1015;328;253;75
GAÚCHA DO NORTE;57;36;1015;329;268;61
GAÚCHA DO NORTE;57;39;1031;336;233;103
PARANATINGA;57;41;1031;329;233;96
PARANATINGA;57;41;1031;328;232;96
PARANATINGA;57;42;1023;334;232;102
GAÚCHA DO NORTE;57;43;1058;297;199;98
GAÚCHA DO NORTE;57;43;1058;295;197;98
PARANATINGA;57;45;1163;174;118;56
GAÚCHA DO NORTE;57;46;1015;331;242;89
PARANATINGA;57;47;1171;57;31;26
PARANATINGA;57;48;1139;439;310;129
GAÚCHA DO NORTE;57;49;1015;332;266;66
GAÚCHA DO NORTE;57;50;1074;361;258;103
GAÚCHA DO NORTE;57;50;1074;360;257;103
GAÚCHA DO NORTE;57;51;1082;104;96;8
GAÚCHA DO NORTE;57;51;1082;103;95;8
GAÚCHA DO NORTE;57;52;1074;359;259;100
PARANATINGA;57;53;1040;353;251;102
GAÚCHA DO NORTE;57;54;1074;360;275;85
PARANATINGA;57;55;1198;294;197;97
PARANATINGA;57;56;1210;360;277;83
PARANATINGA;57;57;1201;260;184;76
PARANATINGA;57;58;1228;134;87;47
PARANATINGA;57;59;1090;230;158;72
GAÚCHA DO NORTE;57;60;1058;290;182;108
GAÚCHA DO NORTE;57;61;1074;359;260;99
PARANATINGA;57;62;1252;339;210;129
GAÚCHA DO NORTE;57;63;1104;107;67;40
PARANATINGA;57;64;1058;184;163;21
PARANATINGA;57;65;1210;355;257;98
PARANATINGA;57;66;1040;352;240;112
PARANATINGA;57;67;1201;259;186;73
PARANATINGA;57;68;1023;341;226;115
GAÚCHA DO NORTE;57;76;1015;333;246;87
GAÚCHA DO NORTE;57;78;1112;156;123;33
PARANATINGA;57;79;1031;331;227;104
GAÚCHA DO NORTE;57;80;1015;330;241;89
GAÚCHA DO NORTE;57;81;1074;363;268;95
PARANATINGA;57;82;1252;235;178;57
CAMPO NOVO DO PARECIS;60;18;1015;300;226;74
CAMPO NOVO DO PARECIS;60;19;1015;301;228;73
CAMPO NOVO DO PARECIS;60;20;1015;313;230;83
CAMPO NOVO DO PARECIS;60;21;1015;295;221;74
CAMPO NOVO DO PARECIS;60;22;1015;305;229;76
CAMPO NOVO DO PARECIS;60;23;1015;305;225;80
CAMPO NOVO DO PARECIS;60;24;1015;306;242;64
CAMPO NOVO DO PARECIS;60;25;1015;300;241;59
CAMPO NOVO DO PARECIS;60;26;1015;295;239;56
CAMPO NOVO DO PARECIS;60;27;1015;302;242;60
CAMPO NOVO DO PARECIS;60;28;1015;296;237;59
CAMPO NOVO DO PARECIS;60;29;1015;295;233;62
CAMPO NOVO DO PARECIS;60;30;1015;290;231;59
CAMPO NOVO DO PARECIS;60;31;1015;297;240;57
CAMPO NOVO DO PARECIS;60;32;1015;299;241;58
CAMPO NOVO DO PARECIS;60;33;1023;237;153;84
CAMPO NOVO DO PARECIS;60;34;1023;233;166;67
CAMPO NOVO DO PARECIS;60;35;1023;245;159;86
CAMPO NOVO DO PARECIS;60;36;1023;237;164;73
CAMPO NOVO DO PARECIS;60;37;1031;310;248;62
CAMPO NOVO DO PARECIS;60;38;1040;389;279;110
CAMPO NOVO DO PARECIS;60;39;1040;379;286;93
CAMPO NOVO DO PARECIS;60;40;1040;379;283;96
CAMPO NOVO DO PARECIS;60;41;1040;382;281;101
CAMPO NOVO DO PARECIS;60;42;1040;383;280;103
CAMPO NOVO DO PARECIS;60;43;1058;396;292;104
CAMPO NOVO DO PARECIS;60;45;1058;380;299;81
CAMPO NOVO DO PARECIS;60;48;1058;381;302;79
CAMPO NOVO DO PARECIS;60;49;1058;393;292;101
CAMPO NOVO DO PARECIS;60;52;1058;378;295;83
CAMPO NOVO DO PARECIS;60;53;1040;371;275;96
CAMPO NOVO DO PARECIS;60;56;1058;372;297;75
CAMPO NOVO DO PARECIS;60;57;1058;374;296;78
CAMPO NOVO DO PARECIS;60;58;1058;384;291;93
CAMPO NOVO DO PARECIS;60;59;1058;389;296;93
CAMPO NOVO DO PARECIS;60;60;1040;380;276;104
CAMPO NOVO DO PARECIS;60;61;1031;315;238;77
CAMPO NOVO DO PARECIS;60;62;1066;449;305;144
CAMPO NOVO DO PARECIS;60;64;1058;385;307;78
CAMPO NOVO DO PARECIS;60;65;1066;442;324;118
CAMPO NOVO DO PARECIS;60;66;1031;311;248;63
CAMPO NOVO DO PARECIS;60;68;1066;430;309;121
CAMPO NOVO DO PARECIS;60;69;1066;449;334;115
CAMPO NOVO DO PARECIS;60;70;1066;440;330;110
CAMPO NOVO DO PARECIS;60;71;1058;384;301;83
CAMPO NOVO DO PARECIS;60;72;1066;443;326;117
CAMPO NOVO DO PARECIS;60;73;1066;449;319;130
CAMPO NOVO DO PARECIS;60;74;1066;460;324;136
CAMPO NOVO DO PARECIS;60;76;1066;450;300;150
CAMPO NOVO DO PARECIS;60;77;1104;403;304;99
CAMPO NOVO DO PARECIS;60;78;1090;402;304;98
CAMPO NOVO DO PARECIS;60;79;1090;390;309;81
CAMPO NOVO DO PARECIS;60;80;1104;421;313;108
CAMPO NOVO DO PARECIS;60;81;1090;418;322;96
CAMPO NOVO DO PARECIS;60;82;1090;406;298;108
CAMPO NOVO DO PARECIS;60;83;1090;410;292;118
CAMPO NOVO DO PARECIS;60;84;1090;397;286;111
CAMPO NOVO DO PARECIS;60;85;1104;434;306;128
CAMPO NOVO DO PARECIS;60;86;1066;466;325;141
CAMPO NOVO DO PARECIS;60;87;1090;415;314;101
CAMPO NOVO DO PARECIS;60;88;1090;408;292;116
CAMPO NOVO DO PARECIS;60;89;1066;484;322;162
CAMPO NOVO DO PARECIS;60;90;1104;455;306;149
CAMPO NOVO DO PARECIS;60;91;1090;428;290;138
CAMPO NOVO DO PARECIS;60;92;1066;471;337;134
CAMPO NOVO DO PARECIS;60;93;1112;91;70;21
CAMPO NOVO DO PARECIS;60;94;1090;386;299;87
CAMPO NOVO DO PARECIS;60;95;1104;368;267;101
CAMPO NOVO DO PARECIS;60;96;1066;394;301;93
CAMPO NOVO DO PARECIS;60;97;1090;354;241;113
CAMPO NOVO DO PARECIS;60;98;1066;399;285;114
CAMPO NOVO DO PARECIS;60;99;1104;358;254;104
CAMPO NOVO DO PARECIS;60;100;1066;396;332;64
COMODORO;61;1;1015;291;202;89
COMODORO;61;3;1015;288;201;87
COMODORO;61;7;1023;207;139;68
COMODORO;61;8;1155;320;229;91
COMODORO;61;9;1155;323;227;96
COMODORO;61;10;1155;319;223;96
COMODORO;61;11;1031;356;229;127
COMODORO;61;12;1031;355;241;114
COMODORO;61;13;1031;356;229;127
COMODORO;61;14;1031;358;249;109
COMODORO;61;15;1031;350;230;120
COMODORO;61;16;1031;348;225;123
COMODORO;61;17;1031;354;248;106
COMODORO;61;18;1040;325;220;105
COMODORO;61;18;1040;323;218;105
COMODORO;61;19;1040;328;236;92
COMODORO;61;20;1040;323;227;96
COMODORO;61;21;1040;325;232;93
COMODORO;61;22;1112;270;199;71
COMODORO;61;23;1112;264;187;77
COMODORO;61;24;1112;262;199;63
COMODORO;61;25;1058;316;229;87
COMODORO;61;26;1058;321;235;86
COMODORO;61;27;1058;323;225;98
COMODORO;61;28;1058;313;237;76
COMODORO;61;29;1066;209;169;40
COMODORO;61;30;1066;205;163;42
COMODORO;61;31;1074;341;231;110
COMODORO;61;32;1090;208;151;57
NOVA LACERDA;61;33;1015;212;161;51
NOVA LACERDA;61;34;1031;335;224;111
NOVA LACERDA;61;35;1031;328;219;109
NOVA LACERDA;61;36;1031;330;201;129
NOVA LACERDA;61;37;1031;324;222;102
NOVA LACERDA;61;38;1031;329;222;107
NOVA LACERDA;61;39;1031;327;230;97
NOVA LACERDA;61;40;1031;330;241;89
COMODORO;61;47;1074;341;236;105
NOVA LACERDA;61;49;1031;332;230;102
COMODORO;61;50;1058;316;221;95
COMODORO;61;52;1082;302;207;95
COMODORO;61;53;1104;281;206;75
COMODORO;61;54;1074;345;237;108
COMODORO;61;55;1120;228;164;64
COMODORO;61;56;1139;307;232;75
COMODORO;61;57;1104;277;198;79
COMODORO;61;59;1015;150;121;29
COMODORO;61;62;1074;338;239;99
COMODORO;61;63;1090;210;154;56
NOVA LACERDA;61;64;1031;333;214;119
COMODORO;61;65;1066;207;172;35
COMODORO;61;66;1104;282;208;74
NOVA LACERDA;61;68;1058;263;173;90
NOVA LACERDA;61;69;1031;337;218;119
COMODORO;61;70;1104;273;199;74
RONDOLÂNDIA;61;74;1015;241;155;86
RONDOLÂNDIA;61;75;1015;241;157;84
RONDOLÂNDIA;61;76;1015;243;169;74
RONDOLÂNDIA;61;77;1015;241;167;74
RONDOLÂNDIA;61;78;1015;242;159;83
RONDOLÂNDIA;61;79;1015;242;174;68
RONDOLÂNDIA;61;80;1015;237;169;68
RONDOLÂNDIA;61;81;1015;237;167;70
RONDOLÂNDIA;61;82;1015;237;171;66
RONDOLÂNDIA;61;83;1015;242;170;72
RONDOLÂNDIA;61;84;1066;222;136;86
CONQUISTA D'OESTE;61;85;1031;314;240;74
CONQUISTA D'OESTE;61;86;1023;352;248;104
CONQUISTA D'OESTE;61;87;1023;358;268;90
CONQUISTA D'OESTE;61;88;1023;358;271;87
CONQUISTA D'OESTE;61;89;1023;356;251;105
CONQUISTA D'OESTE;61;90;1031;309;219;90
CONQUISTA D'OESTE;61;91;1031;311;212;99
CONQUISTA D'OESTE;61;92;1031;309;216;93
NOVA LACERDA;61;93;1031;329;218;111
COMODORO;61;94;1031;354;225;129
CONQUISTA D'OESTE;61;95;1023;357;238;119
COMODORO;61;96;1074;349;242;107
COMODORO;61;97;1104;276;203;73
COMODORO;61;98;1058;318;216;102
COMODORO;61;99;1155;324;231;93
NOVA LACERDA;61;100;1058;176;142;34
NOVA LACERDA;61;101;1031;332;209;123
COMODORO;61;102;1163;195;186;9
RONDOLÂNDIA;61;103;1082;132;113;19
